gameExpired=This Alpha version has expired.<br>Thank you for trying Across the Obelisk.
notAvailable=** Feature <b>not available</b> on this EA version.
accept=Kabul et
cancel=İptal et
select=Seç
continue=Devam et
password=Şifre
close=Kapat
exit=Çıkış
shuffle=Karıştır
modify=Değiştir
resign=Ayrıl
reloadCombat=Savaşı<br>Yenile
combat=Savaş
settings=Ayarlar
allCards=Tüm Kartlar
ready=Hazır
success=Başarılı
successCritical=Kritik başarı
fail=Başarısız
failCritical=Kritik başarısızlık
immune=Bağışıklık
health=Sağlık
speed=Hız
energy=Enerji
rarity=Nadirlik
cardsTier=Kart seviyeleri
maximumAbb=Maks.
sold=Satıldı
stats=İstatistikler
perks=Yetenekler
skin=Kostümler
rank=Rütbe
cardback=Kart dekorları
combatStats=Savaş istatistikleri
mainStats=Ana istatistikler
dataPerTurn=<%>/Sıra
baseResist=Temel direnç
baseDamage=Temel hasar
baseValue=Temel değer
baseDT=Alınan temel hasar
allDamage=Tüm hasar
healDone=Yapılan Şifa
healTaken=Alınan Şifa
damageResistance=Hasar direnci
damageResistanceMax=(95 maks.)
damagePercentMin=(-50% min.)
damageDone=Hasar ver 
damageTaken=Alınan hasar
damageBlocked=Bloklanan hasar
directDamage=Doğrudan hasar
detailedDamage=Ayrıntılı hasar
globalModifiers= ??Global modifiers??
damage=Hasar
resistance=Direnç
resistances=Dirençler
resistancesAndBonus=Dirençler ve bonuslar
activeEffects=Aktif etkiler
immunities=bağışıklıklar
chargeBonus=Aura/lanet bonusları
remove=Kaldır
corrupt=Corrupt
skip=Geç
blocked=Bloklandı
evaded=Kaçınıldı
resisted=Direnildi
currentHp=Mevcut sağlık
#########
######### CreateTextMenu
#########
menuPlay=Oyna
menuLoadGame=Oyun Yükle
menuChallenge=Dikilitaş Mücadelesi
menuWeekly=Haftalık Mücadele
menuMultiplayer=Çok Oyunculu
menuTome=Bilgelik Kitabı
menuStatistics=İstatistikler
menuOptions=Ayarlar
menuQuit=Oyundan Çık
menuChallenge=Dikilitaş Mücadelesi
mainMenu=Ana Menü
inputNameMultiplayer=Çok oyunculu oyunlara katılabilmek veya oyun oluşturabilmek için lütfen aşağıdaki metin kutusuna takma adınızı girin.
playersReady=Oyuncular hazır
waitingForPlayers=Oyuncular bekleniyor
wantToQuitGame=Oyundan çıkmak istediğine emin misin?
wantToRemoveSave=Bu kayıtlı oyunu silmek istediğine emin misin?
wantToRemoveSavePermanent=Kalıcı olarak silinecektir.
saveAvailable=[Available]
back=Geri
backMainMenu=<size=+10><< Geri</size><br>Ana menü
singleplayer=Tek Oyunculu
multiplayer=Çok Oyuncul
weeklySingleplayer=Haftalık Tek Oyunculu
weeklyMultiplayer=Haftalık Çok Oyunculu
obeliskChallenge=Dikilitaş Mücadelesi
obeliskChallengeSingleplayer=Dikilitaş Mücadelesi Tek Oyunculu
obeliskChallengeMultiplayer=Dikilitaş Mücadelesi Çok Oyunculu
weekNumber=Hafta {0}
mainMenuSaveSingle=Tek oyunuclu oyun
mainMenuSaveMulti=Çok oyunculu oyun
mainMenuCreateNewGame=Yeni oyun oluştur
mainMenuClickUseThis=Bu slotu kullanmak için buraya tıklayın
mainMenuDelete=Sil
mainMenuSaveDescription=Bu oyun için bir kayıt yuvası seçin (veya önceden kaydedilmiş bir oyunu yükleyin).
mainMenuGameModeChoose=Bir oyun modu seç.
mainMenuAdventureDescription=<color=#FFD98F>Senenthia'nın tarihini ortaya çıkar.</color><br><br>Bu roguelite macerasında yeni karakterler keşfedin, kartların kilidini açın ve zorlu düşmanlarla savaşın.
mainMenuObeliskDescription=<color=#FFD98F>Tamamen rastgele bir roguelike macera.</color><br><br>Dikilitaşa ulaşmaya çalışırken, karanlıkta ilerlediğin her oyun birbirinden farklı olacaktır. 
mainMenuWeeklyDescription=<color=#FFD98F>Diğer oyunculara karşı yarış.</color><br><br>Her hafta yeni bir kurallar dizisi ve sabit karakterler ile en yüksek puanı kimin alabileceğini gör.
modeAdventure=Macera modu
modeObelisk=Dikilitaş Mücadelesi
modeWeekly=Haftalık Mücadele
obeliskNeedCharacter=Rütbesi 3 olan bir karaktere ihtiyacınız var
joinMultiplayer=Çok oyunculu bir oyuna katıl
abortMultiplayer=Bir oyuncunun bağlantısı kesildi. Mevcut oyun kapanacak. Yeni bir oyun oluşturabilir ve son kayıt noktasından devam edebilirsiniz.
abortSave=Oyunu kaydederken bir hata oluştu. Daha fazla sorun yaşanmaması için oyun şimdi kapanacak. Yeni bir oyun oluşturabilir ve son kaydetme noktasından devam edebilirsiniz.
enterText=Metin girin...
waitingPlayers=Oyuncular bekleniyor...
exitRoom=Odadan çıkış
steamInvite=Steam arkadaşlarını davet et
roomFull=Oda dolu.
openSlot=[açık slot]
roomId=Oda Kodu
master=Yönetici
slash=Kesme
piercing=Delme
blunt=Darbe 
fire=Ateş
cold=Soğuk
lightning=Yıldırım
mind=Zihin
holy=Kutsal
shadow=Gölge
#########
######### CreateTextGameplay
#########
index=İndeks
loading=Yükleniyor
deck=Deste
characterMenuCards=<sprite name=cards> Kahraman Destesi
characterMenuLevel=<sprite name=experience> Seviye ve Özellikler
characterMenuItems=<sprite name=block> Ekipman
characterMenuStats=<sprite name=sheet> Karakter Sayfası
characterMenuPerks=<sprite name=perk> Yetenekler
characterMenuCombatDraw=<sprite name=cards> Deste
characterMenuCastedCards=<sprite name=cards> Oyuncu Kartları
characterMenuCombatDiscard=<sprite name=cardsdiscard> Atılmış Kartlar
characterMenuCombatVanish=<sprite name=vanish> Yok Olan Kartlar
traits=Özellikler
activatedTraits=Etkinleştirilmiş özellikler
traitsList=Innate *** <br>Level 2<br>Level 3<br>Level 4<br>Level 5
item=Eşya
initialCards=Başlangıç kartları
incrementMaxHp=+<N> Maks Sağlık
level=Seviye
levelNumber=Seviye <N>
warriors=Savaşçılar
mages=Büyücüler
healers=Şifacılar
scouts=Öncü
mageknights=Büyücü Savaşçılar
monsters=Düşmanlar
warriorCards=Savaşçı Kartları
mageCards=Büyücü Kartları
healerCards=Şifacı Kartları
scoutCards=Öncü Kartları
injuries=Yaralar
boons=Boons
equipment=Ekipmanlar
upgradedCard=Yükseltme
upgradesTo=Buna yükseltilebilir
upgradedFrom=Şundan yükseltildi
transmutesTo=Şuna dönüştür
sourceCard=Kaynak Kart
unlockedCard=Kilidi açık
unlockedHero=Kilidi açık
unlockedCards=Kilidi açık kartlar
unlockTable=Kilitli Olmayan Öğeler
glossary=Sözlük
termsGlossary=Terimler Sözlüğü
termsDescription=Oyunda kullanılan auraların, lanetlerin ve efektlerde kullanılan terimlerin özetleri ve açıklamaları.
gameplayStatistics=Oynanış İstatistikleri
bestScoreTome=En iyi skor:
lastRuns=Geçmiş oyunlar
scoreboards=Skor Tabelası
chooseScoreboard=Bir Skor Tablesı Seç.
scoresNotFound=Skorlar bulunamadı
travelPath=Travel path ***
path=Path
cardsUnlockedTome=Kilidi açık kartlar:
adventuresPlayedTome=Oynanan maceralar:
treasuresClaimedTome=Toplanan hazineler:
monstersKilledTome=Öldürülen düşmanlar:
bossesKilledTome=Öldürülen Boss sayısı:
corruptionsCompleted=Corruptions *** completed:
adventureCompleted=Tamamlanan maceralar:
uniqueBosses=Eşsiz Bosslar
experienceGainedTome=Kazanılan tecrübe:
equipmentDiscoveredTome=Keşfedilen ekipmanlar:
heroDeaths=Kahraman ölümleri:
totalResources=Toplam kaynaklar:
gold=Altın
shards=Kristaller
goldGainedTome=Kazanılan altınlar:
dustGainedTome=Kazanılan kristaller:
cardsCraftedTome=Oluşturulan kartlar:
cardsUpgradedTome=Yükseltilmiş kartlar:
purchasedItemsTome=Satın alınan eşyalar:
corruptionsCompletedTome=Corruptions completed:
Melee_Attack=Yakın saldırı
Ranged_Attack=Menzilli saldırı
Magic_Attack=Büyü saldırısı
Defense=Defans
Fire_Spell=Ateş büyüsü
Cold_Spell=Buz büyüsü
Lightning_Spell=Yıldırım büyüsü
Mind_Spell=Zihin büyüsü
Shadow_Spell=Kara büyü
Holy_Spell=Kutsal büyü
Curse_Spell=Lanet büyüsü
Healing_Spell=Şifa büyüsü
Book=Kitap
Small_Weapon=Küçük silah
Song=Şarkı
Skill=Yetenek
Power=Güç
Injury=Yara
Attack=Saldırı
Spell=Büyü
Boon=Boon 
weapon=Silah
armour=Zırh
armor=Zırh
jewelry=Mücevherat
accesory=Aksesuar
enchantment=Efsun
enchantments=Efsunlar
itemActivated=Aktifleştirildi
itemChargeUsed=Kullanılan yük
itemsDescription=Her kahraman için aynı türden yalnızca bir eşyaya izin verilir. Yeni bir eşya takmak üzereyken dikkatli olun: eskisi sonsuza dek kaldırılacaktır.
cardNotUnlockedPopup=<voffset=-2><size=26><sprite name=lock></size></voffset>Kart kilidi açılmadı
minDeckCards=Bir destedeki minimum kart sayısı: <color=#FFFFFF><n></color>
shopDiscount=İndirim
shopIncrease=Fiyat Artışı
heroCards=<hero> kartlar
heroEquipment={0}<br><color=#bbb>Ekipman</color>
heroInjuries=<hero> yaralar
heroInjuriesBoons=<hero> boonlar ve yaralar
heroDrawPile=<hero> deste
heroDiscardPile=<hero> ıskarta kartlar
heroCastedCards=<hero> oyuncu kartları
heroVanishedCards=<hero> yok olan kartlar
town=Kasaba
townPlace={0} Kasaba
townIntro=Acele etmeyin ve maceradan önce destelerinizi ayarlayın. İşiniz bittiğinde, hazır tuşuna basın!
ready=Hazır
charReceive=alınanlar <char>
charsReceives=alınan <chars> 
freeCost=Bedelsiz
oldCost=(Eski bedeli: {0})
reaminingUses=Kalan kullanım
noMoreUses=Daha fazla kullanılamaz
removeCards=Kilise
removeCardsButtonDes=Destenden kart çıkar
removeCardsDes=Minimum kart sayısı şartını yerine getirdiğiniz sürece destenizden kart çıkarabilirsiniz.
upgradeCards=Altar
upgradeCardsButtonDes=Kartlarını yükselt ve daha güçlü versiyonlara dönüştür.
upgradeCardsDes=Her kart, temel versiyondan daha güçlü olan farklı yükseltmelere sahiptir.<br><br>Bir kartı yükseltmek için kristal kullanabilirsiniz.<br><br>Ayrıca, bir kartı yükseltilmiş versiyonları arasında dönüştürmek de mümkündür.<br><br><color=#FFC88F>Kartın nadirliği ne kadar yüksekse, yükseltme maliyeti de o kadar yüksek olur.</color>
reset=Reset
upgradedCards=Yükseltildi
upgradedCardsDes=Yükseltilmiş kartları göster. Ayrıca kartları Altar'da da yükseltebilirsin.
filterCards=Filtrele
filterCardsDes=Kartları özel niteliklere göre filtreleyin.
affordableCards=Mevcut
affordableCardsDes=Yalnızca mevcut kristal sayınızla üretebileceğiniz kartları gösterin.
craftCards=Sihirli demirhane
craftCardsButtonDes=Desten için kart üret.
craftRarityBlocked=Burada bu kart nadirliğine izin verilmez.
craftMaxCards=Bu kart için izin verilen maksimum üretim sayısı
treasureClaimButtonDes=Bu ödülü almak için buraya basın.
wantToClaimTreasure=Bu hazineyi almak istiyor musunuz?
lastRunsRewards=Son ödüller
lastRunsRewardsDes=Her oyun performansınız altın ve kristallerle ödüllendirilecektir.<br><br>Her oyuna başladığınızda en fazla son üç ödülü talep edebilirsiniz.
lastRunsRewardsStack=En fazla 3 sandık biriktirebilirsiniz.
communityRewards=Topluluk ödülleri
expiresInHoursMinutes={0} saat(s) {1} dakika(s) önce sonra erdi
expiresInMinutes={0} dakika(s) önce sona erdi
divinationCards=Zingarian cart ***
divinationCardsButtonDes=Güzel Zingara'ya altın ödeyin ve bir kehanet turu elde edin.
divinationCardsDes=Yeterli paranız varsa, Zingara size bir kehanet kartı turu verecektir.<br><br>Çok oyunculu bir oyunda, herkes bu kehanet turundan faydalanacaktır.<br><br>Bir kehanet turunun maliyeti ne kadar yüksekse, daha iyi kartlar elde etme şansı da o kadar yüksek olur. ***
divinationT0=Hızlı Kehanet
divinationT1=Temel Kehanet
divinationT2=İleri Düzey Kehanet
divinationT3=Premium Kehanet
divinationT4=Üstün Kehanet
divinationRoundJoin={0} az önce bir tur Kart Kehaneti için ödeme yaptı. Hazır olduğunda katılmak için düğmeye bas.
divinationRoundExists=Halihazırda devam etmekte olan bir Kart Kehaneti turu var.
divinationRoundLaunch=Kart Kehanet turu yükleniyor...
sell=Sat
buyItems=Silah deposu
buyItemsButtonDes=Kahramanların için ekipman satın al.
deckPile=Deste
discardPile=Atılmış kartlar
pressWhenReady=Hazır olduğunuzda düğmeye basın.
cardsNum=Cards: {0}
youCanDiscardUpTo=En fazla şu kadar kart ıskartalayabilirsin: {0}
youCanVanishUpTo=En fazla şu kadar kart yok edebilirsin: {0}
youCanAdd=Ekleyebileceğiniz: 1 kart
youCanAddPlural=Ekleyebileceğiniz: {0} kart
#########e
######### performance bonus
#########k
roundNumber=Tur {0}
excellent=Mükemmel
good=Güzel
poor=Kötü
satisfactory=Yeterli
underwhelming=Zayıf
dreadful=Rezalet
great=Harika
performanceBonus=Performans bonusu
combatPerformance=Savaş bonusu
combatPerformanceDes=Düşmanlarınızı hızlı bir şekilde öldürerek tur sayısını olabildiğince düşük tut ve daha iyi ödüller kazan!
dreadfulNoReward=Savaş performansınız rezaletti, bu nedenle herhangi bir kart ödülü alamıyorsunuz.
#########
######### rewards
#########
combatRewards=Savaş ödülleri
eventRewards=Etkinlik ödülleri
eventRewardsSubtitle=Bir kart veya bir miktar arasında seçim yapın
eventYouGet=Kazandıkların:
divinationRoundRewards=Kehanet ödülleri
itemRewards=Eşya ödülleri
itemRewardsSelection=Eşyalardan birini veya aşağıdaki altın miktarını seçebilirsiniz:
itemRewardsChosing=Karakter seçiyor:
chooseCards=Bu kartlardan birini seçin
chooseDust=Kristal al
notEnoughGold=Yeterli altının/kristalin yok
#########
######### finish run
#########
finishRun=Maceranızın performansına dayalı ödül. Yeni bir oyunun başlangıcında, kasabadayken bu ödülü talep edebilirsiniz.
questEndsIn=Your quest ends in ***
actNumber=Act {0}
prologue=Önsöz
congratulations=Tebrikler
placesVisited=Ziyaret edilen yerler
placeOfDeath=Ölümün gerçekleştiği yerler
combatPerformance=Savaş Performansı
experienceGained=Kazanılan tecrübe puanı
bossesKilled=Öldürülen Boss'lar
finalScore=Final skor
timePlayed=Oynanılan zaman {0}
gameScore=Oyun skoru
finishBestScore=En iyi skor!
currencyRetention=Currency retention ***
currencyRetentionBonus=<q>% of total ***
gameReward=Oyun ödülü
mpBonus=Çok oyunculu bonus (+<q>%)
itemBonus=Eşya bonusu (+<q>%)
#########
######### event rolls
#########
eventRolls=Olay Zarı:
singleDesc=Herkes bir kart çeker ve sonuçlar her karakter için ayrıdır.
groupDesc=Herkes bir kart çeker ve sonuçlar toplanır.
competitionDesc=Herkes bir kart çeker ve birbirine karşı yarışır.
single=Tekli
competition=Rekabet
group=Grup
character=Karakter
higherThan=daha yüksek
higherOrEqual={0} ya da daha yüksek
lowerThan=daha düşük
lowerOrEqual={0} ya da daha düşük
rollCard={0} kartı 
highest=en yüksek
lowest=en düşük
closest=en yakın
#########
######### event actions
#########
healPercent=[Sağlık {0}%]
eventBag=Bu çanta, maceranız sırasında bulduğunuz tüm yararlı eşyaları içerir.
eventMissingOptions=Gizli seçenekler
eventMissingOptionsDesc=Bazı cevapların kristal, altın, farklı karakterler gibi özel gereksinimleri vardır...
continueAction=Devam et
joinAction=Katıl
combatAction=Savaş
jumpAction=Zıpla
runAction=Kaç
bribeAction=Rüşvet
threatenAction=Tehdit Et
persuadeAction=İkna et
stealthAction=Gizlen
stealAction=Çal
sneakAwayAction=Sıvış
leaveAction=Ayrıl
lootAction=Yağmala
profaneAction=Kafir
forageAction=Topla
declineAction=Reddet
acceptAction=Kabul et
extorsionAction=Gasp et ***
ambushAction=Pusu at
raceAction=Yarış
restAction=Dinlen
buryAction=Göm
digAction=Kaz
breakAction=Kır
betAction=İddiaya gir
playAction=Oyna
fishingAction=Balık tut 
payAction=Öde
bargainAction=Pazarlık yap
exploreAction=Keşfet
enterAction=Gir
pretendAction=Rol yap
captureAction=Yakala
throwAction=Fırlat
lookAction=Bak
examineAction=İncele
repairAction=Tamir et
rebuildAction=Yenileştir
healAction=İyileş
climbAction=Tırman
evadeAction=Kaçın
useAction=Kullan
askAction=Sor
answerAction=Cevap
openAction=Aç
buyAction=Satın al
murderAction=Cinayet
burnAction=Yak
killAction=Öldür
giveAction=Ver
talkAction=Konuş
singAction=Şarkı söyle
readAction=Oku
confirm=Onayla
hide=Gizle
show=Göster
chooseEnergy=Bu büyüyü yapmak için ne kadar enerji harcayacağını seç.
chooseEnergyAvailable=Kullanılabilir enerji:
chooseEnergyMax=Kullanılabilecek maksimum enerji:
#########
######### CreateTextLobby
#########
exitGameConfirm=Çıkmak istediğinden emin misin?
exitGameConfirmLoss=Tüm ilerlemen kaybolacaktır.
exitGameConfirmSave=Mevcut ilerlemen kaydedilecektir.
exitGameRewards=Oyundan çıkmadan önce ödüllerini almalısın.
exitGameEvent=Oyundan çıkmadan önce aktif olayı bitirmelisin.
exitRoomConfirm=Oyun odasından çıkmak istediğine emin misin?
inputPasswordRoom=Lütfen oda şifresini gir ve butona bas.
inputIDRoom=Lütfen oda kodunu gir
joinById=Kod kullanarak katıl
launchGame=Oyunu başlat
inviteSteamFriends=Steam Arkadaşlarını Davet Et
statusMP=Çok oyunculu durumu
statusConnecting=Çok oyunculu sunucuya bağlanıyor
statusJoinedLobby=Lobiye Girildi
statusConnected=Sunucuya bağlanıldı
chatPlayerJoined=%p oyuna katıldı.
chatPlayerLeft=%p oyundan ayrıldı.
chatPlayerKicked=%p oyundan atıldı.
masterKickedYou=Oyundan atıldın.
playersInGame=Oyundaki oyuncular:
multiplayerDescription=En fazla 3 arkadaşınızla maceraya katılın! Bir oyun oluştur veya başka bir oyuncunun odasına katıl. Kahramanlarınızı seçin ve maceraya başlayın.
multiplayerSubDescription=* Çok oyunculu bir oyunda, yalnızca daha önce kilidini açtığınız kahramanları seçebileceksiniz. Öte yandan, çok oyunculu bir oyunda kahramanların kilidini açmak, mevcut herhangi bir modda açtığınız kahramanlarla oynamanıza izin verecektir.
availableRooms=Müsait odalar
chooseRoom=Bir oyun odası seç.
createRoom=Bir oyun odası oluştur.
roomDescription=Oyun açıklaması
numberOfPlayers=Oyuncu sayısı
privateRoom=Özel oda
roomPasswordDesc=** Sadece şifreyi bilen kullanıcılar odaya katılabilecektir.
createRoomButton=Oda oluştur
disconnect=Bağlantıyı Kes
selectRegion=Bölge seçiniz
connectedRegion=Bağlanılan <br>Bölge: [{0}]
regionEU=EU Bölgesi
regionUS=US Bölgesi
regionASIA=ASIA Bölgesi
lfgLobby=<color=#DB9D6A>Eşli oynamak için birilerini mi arıyorsun?</color><br>Resmi Discord'umuzdaki #LFG kanalına katıl!
#########
######### CreateTextSelection
#########
adventure=Macera
beginAdventure=Maceraya başla
teamSelection=Takım Seçimi
dragCharacters=Bu oyunda kullanmak istediğiniz karakterleri sürükleyin ve ekleyin.<br>Bazı saldırılar sadece ön, arka veya orta birimleri hedef alabilir.
heroselectionWeekly=Bunlar, bu Mücadelede kontrol edebileceğiniz karakterlerdir.
dragRecommended=* Bu pozisyon için önerilen sınıf
positionFront=Ön kısım
positionBack=Arka kısım
masterAssign=Oyunun yöneticisi her yuvaya bir oyuncu atamalıdır. Tüm oyuncular hazır butonuna bastığı zaman, oyun başlamaya hazır olacaktır.
helpCharacterHealth=Karakterin sağlık puanları
helpCharacterEnergy=Karakterin ilk enerjisi ve sırasının başında kazanacağı miktar
helpCharacterSpeed=Karakterin hızı En yüksek hıza sahip karakter her turda ilk hareket eden olacaktır.
tutorialTownTitle=Kasaba eylemleri
tutorialTown=Desteleriniz için yeni kartlar üretebilir, sahip olduğunuz herhangi bir kartı yükseltebilir ve kahramanlarınız için ekipman satın alabilirsiniz. Ayrıca önceki oyunlardan ödüller de talep edebilirsiniz.
tutorialCombatSpeedTitle=Hız ve karakter sırası
tutorialCombatSpeed=Tüm karakterlerin bir hız değeri vardır (bu değer kartlar, eşyalar ve özelliklerle değiştirilebilir). Bu değer kimin önce hareket edeceğini belirler. Eşitlik durumunda, merkeze *** en yakın KAHRAMAN öncelikli olacaktır.
tutorialFirstTurnEnergyTitle=Enerji yönetimi ve kartlar
tutorialFirstTurnEnergy=Enerjiniz bitene kadar kart oynayabilirsiniz.<br><br>Turunu bitirdiğin zaman, kullanılmamış enerjiler sonraki tur için saklanacaktır.
tutorialCombatCardTargetTitle=Card targets *** 
tutorialCombatCardTarget=Bu kutu mevcut hedefleri gösterir.<br><br>Bir kart için birden fazla hedef varsa, hangisinin etkileneceğini seçmeniz gerekir. Yalnızca bir tane varsa, kartı serbest bırakmak otomatik olarak onu seçecektir.
tutorialCombatResistsTitle=Hasar ve dirençler
tutorialCombatResists=9 farklı hasar türü ve direnç türü vardır.<br><br>Bir kartta listelenen hasar değerleri, hedefin direnç yüzdesi kadar azaltılacaktır.
tutorialEventRollsTitle=Etkinlik Zarları
tutorialEventRolls=Bazı seçenekler, eylemin sonucunu belirlemek için sizi zar atmaya zorlayacaktır. Her karakter kendi destesindeki kartları kullanacaktır.
tutorialTownRewardsTitle=Biten oyun ödülleri
tutorialTownRewards=Kasabadayken, geçmiş oyunlarda elde ettiğiniz ödülleri talep edebilirsiniz. Bu ödülleri almak için çok beklemeyin: sadece son üç oyunun ödülü saklanacaktır.
tutorialCardsRewardTitle=Kilitli kartlar
tutorialCardsReward=Maceralarınız sırasında, her savaştan sonra yeni kartlar keşfedeceksiniz. Gösterilen tüm kartların kilidi açılacaktır. Unutmayın: sadece kilidi açılmış kartları üretebileceksiniz.
tutorialCharactersTitle=Takımınızı ayarlayın.
tutorialCharacters=Maceralarınız sırasında görevleri tamamlayarak yeni karakterlerin kilidini açın. Karakter görevleri bu simge ile işaretlenmiştir: <size=+.5> <sprite name=questBegin></size>.
tutorialPerksTitle=Karakter yetenekleri
tutorialPerks=Bir maceranın sonunda, grubunuzdaki tüm karakterler deneyim puanı kazanacaktır (her rütbe seviyesi size Yetenek puanı kazandıracaktır). Bu Yetenek puanlarını karakter yükseltmeleri için harcayabilirsiniz.
tutorialTownCraftTitle=Kart üretimleri
tutorialTownCraft=Her kasabada, tüm kahramanlarınız için daha önce kilidini açtığınız kartları üretebileceksiniz. Kasaba yükseltmelerinize bağlı olarak bazı kısıtlamalar uygulanacaktır.
watchingTutorial=[Lütfen Bekleyin]<br>Başka bir oyuncu bir öğreticiyi izliyor.
castNPCTitle=Düşman kartları
castNPC=Düşmanların kullanacağı kartlar varsayılan olarak gizlidir. "Görüş"  <sprite name=sight> efekti bu kartları görmene yardımı olacaktır, hareketlerinizi önceden planlamanıza olanak tanır.
levelUp=Seviye Atlandı!
cantLevelUp=Sadece kasabadayken veya harita ekranındayken seviye atlayabilirsiniz.
cantGiveGoldDivination=Bir kehanet turu devam ederken altın veya kristal veremezsiniz.
gameSeed=Oyun Kodu (Game seed)
gameSeedInput=Lütfen yeni bir oyun kodu giriniz.
#########
######### CreateTextCards
#########
requireSkill={0} Gerekir
priority=Öncelik: {0}
global=Herkes
friends=Dostlar
self=Kendine
random=Rastgele
hero=Kahraman
anyone=Herhangi biri
heroes=Kahramanlar
monsters=Düşmanlar
allHeroes=Tüm Kahramanlar
randomHero=Rastgele Kahraman
frontHero=En Öndeki Kahraman
backHero=En Arkadaki Kahraman
middleHero=Ortadaki Kahraman
slowestHero=En Yavaş Kahraman
fastestHero=En Hızlı Kahraman
leastHPHero=En Düşük Canlı Kahraman
mostHPHero=En Yüksek Canlı Kahraman
otherHero=Diğer Kahramanlar
monster=Düşman
allMonsters=Tüm Düşmanlar
randomMonster=Rastgele Düşman
frontMonster=En Öndeki Düşman
backMonster=En Arkadaki Düşman
middleMonster=Ortadaki Düşman
slowestMonster=En Yavaş Düşman
fastestMonster=En Hızlı Düşman
leastHPMonster=En Düşük Canlı Düşman
mostHPMonster=En Yüksek Canlı Düşman
priorityBack=En Arka
priorityMiddle=Ortadaki Kahramanalar
priorityFront=En Ön
priorityAnyButBack=En Arka hariç herhangi biri
priorityLessHealthPercent=En Düşük Sağlık Yüzdesi
priorityMoreHealthPercent=En Yüksek Sağlık Yüzdesi
priorityLessHealthFlat=En Düşük Sağlık
priorityMoreHealthFlat=En Yüksek Sağlık
priorityLessHealthAbsolute=En Düşük Mutlak Sağlık
priorityMoreHealthAbsolute=En Yüksek Mutlak Sağlık
priorityLessInitiative=En Yavaş
priorityMoreInitiative=En Hızlı
damageType=Hasar tipi
damageTypes=Hasar tipleri
aura=Aura
curse=Lanet
deal=Vur
apply=Uygula
gain=Elde et
youGain=Elde edersin
suffer=Ye
youSuffer=Yersin
lose=Kaybet
youLose=Kaybedersin
grant=Bahşet
heal=İyileş
draw=Çek
discard=Elden çıkar
discover=Keşfet
reveal=Göster
pick=Seç
place=Yerleştir
look=Bak
onDraw=Çekildiğinde
onEndTurn=Turun sonunda
endTurn=Turu bitir
#########
######### CreateTextCombat
#########
newTurn=Yeni tur
chooseDiscard=Elden çıkarmak istediğinizi seç.
chooseTopDeck=Destenin en üstüne koyulacak kartı seç.
cardsLeft=Kalan kartlar:
combatEffects=Savaş efektleri
combatVictory=Zafer!
combatFail=Göreviniz burada sona eriyor...
combatOnlyMasterCanResign=Sadece odanın sahibi teslim olabilir.
combatWantToRetry=<color=#BBB>Bazen farklı bir yaklaşım benimsemek başarının anahtarıdır.</color><line-height=50><br></line-height>Dövüşü yeniden denemek ister misin?
combatWantToRetryClient=(Oda sahibinin karar vermesi bekleniyor.)
combatWantToResign=<color=#f88>Teslim olmak istiyor musun?</color>
combatWantToResignEnd=Maceranız burada sona erecek.
removeProgressQuestion=Tüm kayıtlı ilerlemenizi gerçekten kaldırmak istiyor musun?
resetTutorialQuestion=Eğitimi sıfırlamak istediğinden emin misin?
mapNodes=Harita noktaları ***
mapEntryPoint=Giriş noktası
mapLegend=Map Legend ***
mapLegendEvent=Etkinlik (nadirlik)
mapLegendCard=Kart noktası ***
mapLegendCrafter=Zanaatkar noktası
mapLegendMapTransition=Harita geçişi 
mapLegendShop=Eşya dükkanı
mapLegendRest=Dinlenme noktası
mapLegendCharacter=Karakter noktası
mapLegendQuestEnd=Görev sonu
mapLegendBoss=Bölgenin Boss'u
typeCardsUnlocked=Açılan kartlar {0}
relatedCard=İlgili Kart
basicValues=* Bunlar kartların temel değerleridir (karakter yetenekleri, karakter yükseltmeleri veya eşya bonusları olmadan).
corruptedVersion=Yükseltilmiş versiyon
specialCard=Özel Kart
characterCard=Karakter Kartı
rareVersion=Ender Versiyon
cardsAnd={0} ve {1}
cardsDealDamage=Hasar ver {0}
cardsSuffer=Kendine {0} uygularsın
cardsYouSuffer=Kendine uyguladıkların {0}
cardsYouLose=Kaybedersin {0}
cardsTargetSides=Yanıbaşındakilere verilen {0}
cardsGrant=Bahşet {0}
cardsGain=Elde et {0}
cardsYouGain=Elde ettiğin {0}
cardsApply=Uygula {0}
cardsDispel=Arındır {0}
cardsDispelAll=Tüm kötü efektleri arındır
cardsPurge=Kaldır {0}
cardsPurgeAll=Tüm iyi efektleri kaldır
cardsTransferCurse=Lanet transfer et {0}
cardsReduceCurse=Lanet bedellerini şu kadar azaltırsın {0}%
cardsCast={0} kartını oynar ***
cardsRepeat={0} Defa tekrarla
cardsRepeatUpTo={0} Defaya kadar tekrar uygulanabilir
cardsRepeatChain=Zincirleme {0}
cardsRepeatJump={0} Defa sek
cardsIgnoreBlock=Bloğu görmezden gel
cardsTransformInto=<nobr>{0} Efektini {1}</nobr> efektine dönüştür 
cardsTransformIntoAnd=<nobr>{0} Efektini {1}, {2}</nobr> efektlerine dönüştür
cardsXEqualsYourHand=(X <nobr>elindekilere {0}{1}</nobr> eşittir)
cardsXEqualsYourDeck=(X <nobr>kart destene {0}{1}</nobr> eşittir)
cardsXEqualsYourDiscard=(X <nobr>ıskartaya {0}{1}</nobr> eşittir)
cardsXEqualsYourVanish=(X <nobr>yok olmuş kartlarına {0}{1}</nobr> eşittir)
cardsXEqualsYourHp=(X Sağlığına eşittir {0})
cardsXEqualsYour=(X üzerindeki {0}{1} sayısına eşittir)
cardsXEqualsTarget=(X buna eşittir {0}{1})
cardsXEqualsTargetHp=(X hedefin sağlığına eşittir {0})
cardsXEqualsTargetDeck=(X hedefin <nobr>destene {0}{1}</nobr> eşittir)
cardsXEqualsTargetDiscard=(X hedefin <nobr>ıskartasına {0}{1}</nobr> eşittir)
cardsXEqualsTargetVanish=(X hedefin <nobr>yok olmuş kartlarına {0}{1}</nobr> eşittir)
cardsShareYour=Böl {0}
cardsDoubleYour={0} Sayısını ikiye katla 
cardsDoubleTarget={0} Sayısını ikiye katla 
cardsTripleYour={0} Sayısını üçe katla 
cardsTripleTarget={0} Sayısını üçe katla 
cardsLosePercentYour={1} bundan {0}% kaybet
cardsLosePercentTarget=Hedef {0}% kaybeder {1}
cardsHeal=İyileştir {0}
cardsHealSelf=Kendini iyileştir {0}
cardsHealSelfPerDamage=verilen hasarın {0}% kadarıyla iyileş 
cardsConsume=tüket {0}
cardsConsumeYour=Tüket {0}
cardsDispelYour=Arındır {0}
cardsPurgeYour=Kaldır {0}
cardsOverCharge=Aşırı Yükleme  {0}
cardsLoseHp=kaybet {0}
cardsDraw=Çek {0}
cardsDiscard={0} elden çıkar
cardsDiscardAny=Herhangi kartını elden çıkar
cardsDiscardUpTo={0} Taneye kadar ıskartala
cardsVanishUpTo={0} Taneye kadar kart yok et
cardsLook=Bak {0}
cardsCost=Enerji maliyeti {0}
cardsCostReducedBy= {0} Kadar azalt
cardsCostUntilDiscarded= Iskarta olana kadar
cardsAddCost=(Enerji maliyeti {0})
cardsAddCostVanish=(Enerji maliyeti {0} ve yok olur)
cardsAddCostVanishTurn=(Enerji maliyeti {0} ve bu tur yok olur)
cardsAddCostTurn=(Kart atılana kadar Enerji maliyeti {0})
cardsAddCostReduced=(Enerji maliyeti {0} kadar azalır)
cardsAddCostReducedVanish=(Enerji maliyeti {0} kadar azalır ve oynandıktan sonra yok olur)
cardsAddCostReducedTurn=(Kopyalanan kartın enerji maliyeti {0} azalır.)
cardsAddCostReducedVanishTurn=(Enerji maliyeti {0} kadar azalır ve bu tur yok olur) ***
cardsDiscoverToDeck={0} keşfet ve destenin içine karıştır.
cardsDiscoverNumberToTopDeck={0} Keşfet ve destenin en üstüne {1} yerleştir
cardsDiscoverNumberToHand={0} Keşfet ve eline {1} yerleştir 
cardsDiscoverNumberToDeck={0} Keşfet ve {1} tanesini destenin arasına karıştır
cardsDiscoverToHand={0} Keşfet ve elindeki kartların arasına yerleştir
cardsPlaceToTop=Elindeki kartlardan {0} al ve destenin üstüne yerleştir
cardsRevealThemToHand=Kart destenden {0} kartını elindeki kartlara yerleştir. ***
cardsRevealItToHand=Kart destenden {0} göster ve elindeki kartlara yerleştir.
cardsRevealNumberToHand=Kart destenden {0} göster ve {1} tanesini elindeki kartlara yerleştir.
cardsRevealItToTopDeck=Kart destenden {0} göster ve destenin en tepesine koy
cardsRevealThemToTopDeck=Kart destenden {0} gösterilen kartları elindeki kartların arasına yerleştir.
cardsRevealNumberToTopDeck=Kart destenden {0} göster ve {1} tanesini destenin en tepesine koy
cardsPickToTop=Oynanmış kartlarından {0} seç ve destenin en tepesine koy
cardsPickToHand=Oynanmış kartlarından {0} seç ve elindeki kartların arasına koy
cardsFromVanishToTop=Yok edilmiş kartlarından {0} seç ve destenin en tepesine koy
cardsFromVanishToHand=Yok edilmiş kartlarından {0} seç ve elindeki kartların arasına koy
cardsDuplicateToHand=Elindeki kartlardan {0} kopyala// 0 => cardname
cardsDuplicateToTargetTopDeck=Elindeki kartlardan {0} kopyala ve hedefin destesinin en tepesine koy// 0 => cardname
cardsDuplicateToTargetRandomDeck=Elindeki kartlardan {0} kopyala ve hedefin destesinin arasına karıştır// 0 => cardname
cardsIDShuffleDeck=Kart destenin arasına {0} karıştır// 0 => cardname
cardsIDShuffleTargetDeck=Hedefin destene {0} karıştır// 0 => cardname
cardsIDPlaceHand=Eline {0} koy// 0 => cardname
cardsIDPlaceTopDeck=Destenin en tepesine {0} yerleştir// 0 => cardname
cardsIDPlaceTargetTopDeck=Hedef destenin en tepesine {0} koy// 0 => cardname
cardsIDPlaceTargetDiscard=Hedefin ıskartasına {0} koy// 0 => cardname
cardsDuplicateHand=Bir kopyasını eline koy// 0 => cardname
cardsSummon=Çağır {0}
cardsImmuneTo=bağışıklık: {0}
cardsTransformDamage=Hasar tipini buna dönüştür {0}
cardsPassEventRoll=Tek karakterli etkinlik zarlarında %100 başarı
killPet=Kahramanların evcil hayvanlarını öldür
requiredPoints={0} kullanılmış puan gerekli
cantDrawAnyCard=Her hangi bir kart çekemezsin
missesThisTurn=Bu turu oynayamıyorsun
itemMaxHp=Maks Sağlık {0}
itemAllResistances=Tüm dirençler {0}
itemXResistances={0} direnç {1}
itemSpeed=Hız {0}
itemInitialEnergy=Başlangıç enerjisi {0}
itemInitialCurrency=Başlangıç altın ve kristalleri {0}
itemCharges={0} yük {1}
itemEnergyRegeneration={0} Yenilenmesi {1}
itemAllDamages=Tüm hasarlar {0}
itemSingleDamage={0} {1} hasar  /// +1 hasar
itemXDamages={0} hasar {1}
itemHealDone=Sağlanan iyileşme {0}
itemCombatStart=Savaş başlangıcı
itemCombatEnd=Savaş bitişi
itemFirstTurn=İlk tur
itemEachTurn=Her tur
itemOncePerTurn=1 kez/Tur başına
itemTwicePerTurn=2 kez/Tur başına
itemThricePerTurn=3 kez/Tur başına
itemFourPerTurn=4 kez/Tur başına
itemFivePerTurn=5 kez/Tur başına
itemDamageDone=Hasar vurulduğunda
itemWhenDamaged=Başkası tarafından hasar alındığında//When damaged
itemWhenDamagedBelow=Başkası tarafından <{0} hasar alındığında
itemWhenHitted=Hasar vurduğunda
itemWhenHealed=Şifa alındığında
itemWhenEvaded=Kaçınıldığında
itemWhenEvade=Kaçındığında
itemWhenBlock=Blokladığında
itemHealDoneAction=Bir kahramana şifa verdiğinde
itemWhenHandEmpty=Elinizi boş bırakan bir  <sprite name=card>oynarsanız ***
itemChanceToDispel={0} arınma şansı: <br> arındır {1}
itemEveryRound=Her turda
itemEveryNRounds=Her {0} turda bir
itemForEveryCharge=Uyguladığın her {0} yük başına, /// "haste"
itemApplyEnemies=Tüm düşmanlara {0} uygula/// "haste"
itemApplyHeroesFromMonster=Tüm kahramanlara {0} uygula/// "haste"
itemApplyHeroes=Tüm kahramanlar {0} kazanır/// "haste"
itemApplyRandomHero=Rastgele bir kahraman {0} kazanır/// "haste"
itemApplyRandomEnemy=Rastgele bir düşmana {0} uygula/// "haste"
itemApplyHighestFlatHpEnemy=En yüksek canlı yaratığa {0} uygula/// "haste"
itemApplyLowestFlatHpEnemy=En düşük canlı yaratığa {0} uygula/// "haste"
itemApplyHighestFlatHpHero=En yüksek canlı kahramana {0} uygula/// "haste"
itemApplyLowestFlatHpHero=En düşük canlı kahramana {0} uygula/// "haste"
itemApplyForEvery=Uyguladığın her {0} yük başına, {1} uygula/// "haste"
itemApplyForEnergyUsed=Kullanılan her {0} enerji için:
itemWhenYouPlay={0} Uyguladığında/// "Cold spell"
itemWhenYouApply={0} Uyguladığında/// "Cold spell"
itemCustomTextMaxChargesIncrasedYouApply={0} you apply has {1} Max. charges ***
itemCustomTextMaxChargesIncrasedOnHeroes={0} on heroes have {1} Max. charges
itemCustomTextMaxChargesIncrasedOnEnemies={0} on monsters have {1} Max. charges
itemCustomTextExplodeChargesMonsters={0}charges on monsters explode at {1}
itemCustomTextAllResistHealingReceived={0} kahramanlar üzerinde yük başına tüm dirençlere +{1}% ve +{2}% şifa alır ***
itemTheNext=Sonraki {0}
itemWhenKilled=Öldüğünde
itemDestroyStartTurn=Bir tur sürer
itemLastUse=1 Defa kullanılabilir
itemLastUses={0} Defa kullanılabilir  
itemOncePerCombat=Savaş başına bir kez
itemTheNext=Sonraki {0}{1}
itemRecoverSelf=Sağlığının {0} kadarı kadar iyileş
itemRecoverLowestHPMonster=En düşük canlı düşman {0} sağlık iyileşir
itemRecoverHeroes=Tüm kahramanlar {0} sağlık iyileşir/// All heroes gain "haste"
itemReduce=Elindeki {0} rastgele {1} maliyetini {3}'e {2} düşür/// reduce the cost of 1 random "Song" in your hand by 1 ***
itemReduceTurn=Elindeki {0} rastgele {1}'in maliyetini {3} atılana kadar {2} azaltır/// reduce the cost of 1 random "Song" in your hand by 1 this turn
itemReduceHighestTurn=Elindeki {0} en yüksek maliyetli {1}'in maliyetini {3} atılana kadar {2} azaltır/// reduce the cost of 1 random "Song" in your hand by 1 this turn ***
itemReduceHighestPermanent=Elindeki {0} en yüksek maliyetli {1}'in maliyetini {3} {2} azaltır.
itemDiscount=Sihirli demirhane, altarlar ve eşya dükkanlarında {0} ekstra indirim
itemDieRetain=Öldüğünüzde, fazladan {0} altın ve kristal elde edersin
itemResurrectHP={0} Sağlık ile diriltilir
customSOR=Öldüğünde, Sağlığının %50'si ile diril ve Diriliş Parşömeni'ni yok et
customSORRare=Öldüğünde, Sağlığının %100'si ile diril ve Diriliş Parşömeni'ni yok et
customBurnedI=-Eğer ateşle oynarsan, yanarsın-
customBrokenI=-Acele işe şeytan karışır-
customVoidMemory=-Sadece bir şeyi unuttuğunu hatırlıyorsun-
customLowSelf=-Bir şeylerin planlandığı gibi gitmediğine dair utanç verici bir hatırlatma-
customSuccess=-Her şeye rağmen kadere meydan okudun ve kazandın-
customTombstone=-R.I.P.-

customSurpriseBox=<size=-.2><color=#3A3A3A>[Combat start]</color><br></size>Bunlardan birini kazan:<br><bl>2</bl><i=fast>, <bl>2</bl><i=powerful>, <bl>2</bl><i=bless>,<br><rd>2</rd><i=slow>, <rd>2</rd><i=vulnerable>, <rd>2</rd><i=mark>
customSurpriseBoxRare=<size=-.2><color=#3A3A3A>[Combat start]</color><br></size>Bunlardan birini kazan:<br><bl>4</bl><i=fast>, <bl>4</bl><i=powerful>, <bl>4</bl><i=bless>,<br><rd>4</rd><i=slow>, <rd>4</rd><i=vulnerable>, <rd>4</rd><i=mark>

customSurpriseGiftBox=<size=-.2><color=#3A3A3A>[Combat start]</color><br></size>Tüm kahramanlar bunlardan birini kazanır:<br><bl>2</bl><i=fast>, <bl>2</bl><i=powerful>, <bl>2</bl><i=bless>,<br><rd>2</rd><i=slow>, <rd>2</rd><i=vulnerable>, <rd>2</rd><i=mark>
customSurpriseGiftBoxRare=<size=-.2><color=#3A3A3A>[Combat start]</color><br></size>Tüm kahramanlar bunlardan birini kazanır:<br><bl>4</bl><i=fast>, <bl>4</bl><i=powerful>, <bl>4</bl><i=bless>,<br><rd>4</rd><i=slow>, <rd>4</rd><i=vulnerable>, <rd>4</rd><i=mark>

customBurningBlood=Bundan<i=bleed>buna dönüştür<i=burn><br>Kazan <bl>X</bl><i=fury><br><size=-.15><gl>(X eşittir senin<i=bleed>x0.3)</gl></size>
customBurningBloodA=Bundan<i=bleed>buna dönüştür<i=burn><br>Bahşet <bl>X</bl><i=fury><br><size=-.15><gl>(X eşittir hedef<i=bleed>x0.5)</gl></size>
customBurningBloodB=Bundan<i=bleed>buna dönüştür<i=burn>x0.5<br>Kazan <bl>X</bl><i=fury><br><size=-.15><gl>(X eşittir senin<i=bleed>x0.5)</gl></size>
customBurningBloodRare=Bundan<i=bleed>buna dönüştür<i=burn>x0.5<br>Kazan <bl>X</bl><i=fury><br><size=-.15><gl>(X eşittir senin<i=bleed>)</gl></size>

customArmagedon=<gl>Tüm düşmanlar bunları kazanır:</gl><br>Tüm hasarlar <bl>+2</bl><br>bağışıklık <i=burn><i=crack><br><gl>-Her tur-</gl><br>Tüm düşmanlara <crd=meteorite,1> ekle.
customArmagedonA=<gl>Tüm düşmanlar bunları kazanır:</gl><br>Tüm hasarlar <bl>+2</bl><br>bağışıklık <i=burn><i=crack><br><gl>-Her tur-</gl><br>Tüm düşmanlara <crd=meteorite,1> ekle.
customArmagedonB=<gl>Tüm düşmanlar bunları kazanır:</gl><br>Tüm hasarlar <bl>+3</bl><br>bağışıklık <i=burn><i=crack><br><gl>-Her tur-</gl><br>Tüm düşmanlara <crd=meteorite,1> ekle.
customArmagedonRare=<gl>Tüm düşmanlar bunları kazanır:</gl><br>Tüm hasarlar <bl>+4</bl><br>bağışıklık <i=burn><i=crack><br><gl>-Her tur-</gl><br>Tüm düşmanlara <crd=meteorite,1> ekle.

customThunderstorm=<gl>Tüm düşmanlar bunları kazanır:</gl><br>Tüm hasarlar <bl>+1</bl><br><i=lightning>bağışıklık <bl>+15%</bl><br><gl>-Her tur-</gl><br>Tüm düşmanlara <crd=storm,1> ekle.
customThunderstormA=<gl>Tüm düşmanlar bunları kazanır:</gl><br>Tüm hasarlar <bl>+2</bl><br><i=lightning>bağışıklık <bl>+20%</bl><br><gl>-Her tur-</gl><br>Tüm düşmanlara <crd=storm,1> ekle.
customThunderstormB=<gl>Tüm düşmanlar bunları kazanır:</gl><br>Tüm hasarlar <bl>+2</bl><br><i=lightning>bağışıklık <bl>+25%</bl><br><gl>-Her tur-</gl><br>Tüm düşmanlara <crd=storm,1> ekle.
customThunderstormRare=<gl>Tüm düşmanlar bunları kazanır:</gl><br>Tüm hasarlar <bl>+3</bl><br><i=lightning>bağışıklık <bl>+30%</bl><br><gl>-Her tur-</gl><br>Tüm düşmanlara <crd=storm,1> ekle.

customWindsofAmnesia=<gl>Tüm düşmanlar bunları kazanır:</gl><br>Maks sağlık <bl>+15</bl><br><gl>-Her tur-</gl><br>Rastgele bir düşmana <crd=tabularasa,1> ekle.</color>
customWindsofAmnesiaA=<gl>Tüm düşmanlar bunları kazanır:</gl><br>Maks sağlık <bl>+25</bl><br><gl>-Her tur-</gl><br>Rastgele bir düşmana <crd=tabularasa,1> ekle.</color>
customWindsofAmnesiaB=<gl>Tüm düşmanlar bunları kazanır:</gl><br>Maks sağlık <bl>+35</bl><br><gl>-Her tur-</gl><br>Rastgele bir düşmana <crd=tabularasa,1> ekle.</color>
customWindsofAmnesiaRare=<gl>Tüm düşmanlar bunları kazanır:</gl><br>Maks sağlık <bl>+45</bl><br><gl>-Her tur-</gl><br>Rastgele bir düşmana <crd=tabularasa,1> ekle.</color>

customNoxiousParasites=<gl>Tüm düşmanlar bunları kazanır:</gl><br>Tüm hasarlar <bl>+2</bl><br>bağışıklık <i=poison><br><gl>-Her tur-</gl><br>Her kahramanın destesine <crd=hatchcorrupt,1> karıştır.
customNoxiousParasitesA=<gl>Tüm düşmanlar bunları kazanır:</gl><br>Tüm hasarlar <bl>+2</bl><br>bağışıklık <i=poison><br><gl>-Her tur-</gl><br>Her kahramanın destesine <crd=hatchcorrupt,1> karıştır.
customNoxiousParasitesB=<gl>Tüm düşmanlar bunları kazanır:</gl><br>Tüm hasarlar <bl>+3</bl><br>bağışıklık <i=poison><br><gl>-Her tur-</gl><br>Her kahramanın destesine <crd=hatchcorrupt,1> karıştır.
customNoxiousParasitesRare=<gl>Tüm düşmanlar bunları kazanır:</gl><br>Tüm hasarlar <bl>+4</bl><br>bağışıklık <i=poison><br><gl>-Her tur-</gl><br>Her kahramanın destesine <crd=hatchcorrupt,1> karıştır.

customMelancholy=<gl>Tüm düşmanlar bunları kazanır:</gl><br>Maks sağlık <bl>+15</bl><br>Tüm dirençler <bl>+10%</bl><br>bağışıklık <i=insane><br><gl>-Her tur-</gl><br>Her kahramanın destesine <crd=sad,2> karıştır.</color>
customMelancholyA=<gl>Tüm düşmanlar bunları kazanır:</gl><br>Maks sağlık <bl>+25</bl><br>Tüm dirençler <bl>+15%</bl><br>bağışıklık <i=insane><br><gl>-Her tur-</gl><br>Her kahramanın destesine <crd=sad,2> karıştır.</color>
customMelancholyB=<gl>Tüm düşmanlar bunları kazanır:</gl><br>Maks sağlık <bl>+35</bl><br>Tüm dirençler <bl>+20%</bl><br>bağışıklık <i=insane><br><gl>-Her tur-</gl><br>Her kahramanın destesine <crd=sad,2> karıştır.</color>
customMelancholyRare=<gl>Tüm düşmanlar bunları kazanır:</gl><br>Maks sağlık <bl>+45</bl><br>Tüm dirençler <bl>+25%</bl><br>bağışıklık <i=insane><br><gl>-Her tur-</gl><br>Her kahramanın destesine <crd=sad,2> karıştır.</color>

customFungalOutbreak=<gl>Tüm düşmanlar bunları kazanır:</gl><br>Tüm hasarlar <bl>+1</bl><br><i=mind> direnç <bl>+15%</bl><br><gl>-Her tur-</gl><br>Rastgele bir kahramanın destesinin en tepesine <crd=magicmushroom,1> ekle.
customFungalOutbreakA=<gl>Tüm düşmanlar bunları kazanır:</gl><br>Tüm hasarlar <bl>+2</bl><br><i=mind> resistance <bl>+20%</bl><br><gl>-Her tur-</gl><br>Rastgele bir kahramanın destesinin en tepesine <crd=magicmushroom,1> ekle.
customFungalOutbreakB=<gl>Tüm düşmanlar bunları kazanır:</gl><br>Tüm hasarlar <bl>+2</bl><br><i=mind> resistance <bl>+25%</bl><br><gl>-Her tur-</gl><br>Rastgele bir kahramanın destesinin en tepesine <crd=magicmushroom,1> ekle.
customFungalOutbreakRare=<gl>Tüm düşmanlar bunları kazanır:</gl><br>Tüm hasarlar <bl>+3</bl><br><i=mind> resistance <bl>+30%</bl><br><gl>-Her tur-</gl><br>Rastgele bir kahramanın destesinin en tepesine <crd=magicmushroom,1> ekle.

customEmpower=<gl>Tüm düşmanlar bunları kazanır:</gl><br>Tüm hasarlar <bl>+1</bl><br><gl>-Her tur-</gl><br>Gain <bl>3</bl><i=powerful>
customEmpowerA=<gl>Tüm düşmanlar bunları kazanır:</gl><br>Tüm hasarlar <bl>+2</bl><br><gl>-Her tur-</gl><br>Gain <bl>3</bl><i=powerful>
customEmpowerB=<gl>Tüm düşmanlar bunları kazanır:</gl><br>Tüm hasarlar <bl>+2</bl><br><gl>-Her tur-</gl><br>Gain <bl>4</bl><i=powerful>
customEmpowerRare=<gl>Tüm düşmanlar bunları kazanır:</gl><br>Tüm hasarlar <bl>+3</bl><br><gl>-Her tur-</gl><br>Gain <bl>4</bl><i=powerful>

customPoisonFields=<gl>Tüm düşmanlar bunları kazanır:</gl><br>Tüm hasarlar <bl>+2</bl><br>bağışıklık <i=poison><br><gl>-Her tur-</gl><br>All heroes suffer <rd>3<rd><i=poison>
customPoisonFieldsA=<gl>Tüm düşmanlar bunları kazanır:</gl><br>Tüm hasarlar <bl>+2</bl><br>bağışıklık <i=poison><br><gl>-Her tur-</gl><br>All heroes suffer <rd>5<rd><i=poison>
customPoisonFieldsB=<gl>Tüm düşmanlar bunları kazanır:</gl><br>Tüm hasarlar <bl>+3</bl><br>bağışıklık <i=poison><br><gl>-Her tur-</gl><br>All heroes suffer <rd>7<rd><i=poison>
customPoisonFieldsRare=<gl>Tüm düşmanlar bunları kazanır:</gl><br>Tüm hasarlar <bl>+4</bl><br>bağışıklık <i=poison><br><gl>-Her tur-</gl><br>All heroes suffer <rd>9<rd><i=poison>

customPacifism=<gl>Tüm düşmanlar bunları kazanır:</gl><br><i=slashing><i=darbe><i=piercing><br>Resistances <bl>+15%</bl><br><gl>-Her iki turda bir-</gl><br>All heroes suffer <rd>1</rd><i=disarm></size>
customPacifismA=<gl>Tüm düşmanlar bunları kazanır:</gl><br><i=slashing><i=darbe><i=piercing><br>Resistances <bl>+20%</bl><br><gl>-Her iki turda bir-</gl><br>All heroes suffer <rd>1</rd><i=disarm></size>
customPacifismB=<gl>Tüm düşmanlar bunları kazanır:</gl><br><i=slashing><i=darbe><i=piercing><br>Resistances <bl>+25%</bl><br><gl>-Her iki turda bir-</gl><br>All heroes suffer <rd>1</rd><i=disarm></size>
customPacifismRare=<gl>Tüm düşmanlar bunları kazanır:</gl><br><i=slashing><i=darbe><i=piercing><br>Resistances <bl>+30%</bl><br><gl>-Her iki turda bir-</gl><br>All heroes suffer <rd>1</rd><i=disarm></size>

customIronclad=<gl>Tüm düşmanlar bunları kazanır:</gl><br>Tüm dirençler <bl>+10%</bl><br><gl>-Savaş başlangıcı-</gl><br>Gain<br><bl>14</bl><i=block> <bl>2</bl><i=reinforce>
customIroncladA=<gl>Tüm düşmanlar bunları kazanır:</gl><br>Tüm dirençler <bl>+15%</bl><br><gl>-Savaş başlangıcı-</gl><br>Gain<br><bl>20</bl><i=block> <bl>3</bl><i=reinforce>
customIroncladB=<gl>Tüm düşmanlar bunları kazanır:</gl><br>Tüm dirençler <bl>+20%</bl><br><gl>-Savaş başlangıcı-</gl><br>Gain<br><bl>26</bl><i=block> <bl>3</bl><i=reinforce>
customIroncladRare=<gl>Tüm düşmanlar bunları kazanır:</gl><br>Tüm dirençler <bl>+25%</bl><br><gl>-Savaş başlangıcı-</gl><br>Gain<br><bl>32</bl><i=block> <bl>4</bl><i=reinforce>

customVigorous=<gl>Tüm düşmanlar bunları kazanır:</gl><br>Max HP <bl>+30</bl><br>Tüm hasarlar <bl>+1</bl>
customVigorousA=<gl>Tüm düşmanlar bunları kazanır:</gl><br>Max HP <bl>+45</bl><br>Tüm hasarlar <bl>+1</bl>
customVigorousB=<gl>Tüm düşmanlar bunları kazanır:</gl><br>Max HP <bl>+60</bl><br>Tüm hasarlar <bl>+2</bl>
customVigorousRare=<gl>Tüm düşmanlar bunları kazanır:</gl><br>Max HP <bl>+75</bl><br>Tüm hasarlar <bl>+2</bl>

customUpwind=<gl>Tüm düşmanlar bunları kazanır:</gl><br>Hız <bl>+3</bl><br>Tüm dirençler <bl>+5%</bl><br><gl>-Savaş başlangıcı-</gl><br>Tüm kahramanlar negatif etki alır <bl>2</bl><i=slow>
customUpwindA=<gl>Tüm düşmanlar bunları kazanır:</gl><br>Hız <bl>+3</bl><br>Tüm dirençler <bl>+10%</bl><br><gl>-Savaş başlangıcı-</gl><br>Tüm kahramanlar negatif etki alır <bl>3</bl><i=slow>
customUpwindB=<gl>Tüm düşmanlar bunları kazanır:</gl><br>Hız <bl>+4</bl><br>Tüm dirençler <bl>+15%</bl><br><gl>-Savaş başlangıcı-</gl><br>Tüm kahramanlar negatif etki alır <bl>3</bl><i=slow>
customUpwindRare=<gl>Tüm düşmanlar bunları kazanır:</gl><br>Hız <bl>+5</bl><br>Tüm dirençler <bl>+20%</bl><br><gl>-Savaş başlangıcı-</gl><br>Tüm kahramanlar negatif etki alır <bl>4</bl><i=slow>

customSacredGround=<gl>Tüm düşmanlar bunları kazanır:</gl><br>Tüm hasarlar <bl>+1</bl><br><i=holy> dirençli <bl>+15%</bl><br><gl>-Savaş başlangıcı-</gl><br>Tüm kahramanlar negatif etki alır <bl>7</bl><i=sanctify>
customSacredGroundA=<gl>Tüm düşmanlar bunları kazanır:</gl><br>Tüm hasarlar <bl>+2</bl><br><i=holy> dirençli <bl>+20%</bl><br><gl>-Savaş başlangıcı-</gl><br>Tüm kahramanlar negatif etki alır <bl>11</bl><i=sanctify>
customSacredGroundB=<gl>Tüm düşmanlar bunları kazanır:</gl><br>Tüm hasarlar <bl>+2</bl><br><i=holy> dirençli <bl>+25%</bl><br><gl>-Savaş başlangıcı-</gl><br>Tüm kahramanlar negatif etki alır <bl>15</bl><i=sanctify>
customSacredGroundRare=<gl>Tüm düşmanlar bunları kazanır:</gl><br>Tüm hasarlar <bl>+3</bl><br><i=holy> dirençli <bl>+30%</bl><br><gl>-Savaş başlangıcı-</gl><br>Tüm kahramanlar negatif etki alır <bl>19</bl><i=sanctify>

customHypotermia=<gl>Tüm düşmanlar bunları kazanır:</gl><br>Tüm hasarlar <bl>+1</bl><br><i=cold> dirençli <bl>+15%</bl><br><gl>Bir kahraman kart oynadığında,</gl> negatif etki alır <rd>2</rd><i=chill>
customHypotermiaA=<gl>Tüm düşmanlar bunları kazanır:</gl><br>Tüm hasarlar <bl>+2</bl><br><i=cold> dirençli <bl>+20%</bl><br><gl>Bir kahraman kart oynadığında,</gl> negatif etki alır <rd>3</rd><i=chill>
customHypotermiaB=<gl>Tüm düşmanlar bunları kazanır:</gl><br>Tüm hasarlar <bl>+2</bl><br><i=cold> dirençli <bl>+25%</bl><br><gl>Bir kahraman kart oynadığında,</gl> negatif etki alır <rd>4</rd><i=chill>
customHypotermiaRare=<gl>Tüm düşmanlar bunları kazanır:</gl><br>Tüm hasarlar <bl>+3</bl><br><i=cold> dirençli <bl>+30%</bl><br><gl>Bir kahraman kart oynadığında,</gl> negatif etki alır <rd>5</rd><i=chill>

customBacklash=<gl>Tüm düşmanlar bunları kazanır:</gl><br>Tüm hasarlar <bl>+2</bl><br>Tüm dirençler <bl>+5%</bl><br><gl>Bir kahraman bir "Büyü" oynadığında,</gl> negatif etki alır <rd>3</rd><i=dark> <rd>2</rd><i=insane>
customBacklashA=<gl>Tüm düşmanlar bunları kazanır:</gl><br>Tüm hasarlar <bl>+2</bl><br>Tüm dirençler <bl>+10%</bl><br><gl>Bir kahraman bir "Büyü" oynadığında,</gl> negatif etki alır <rd>4</rd><i=dark> <rd>2</rd><i=insane>
customBacklashB=<gl>Tüm düşmanlar bunları kazanır:</gl><br>Tüm hasarlar <bl>+3</bl><br>Tüm dirençler <bl>+15%</bl><br><gl>Bir kahraman bir "Büyü" oynadığında,</gl> negatif etki alır <rd>4</rd><i=dark> <rd>3</rd><i=insane>
customBacklashRare=<gl>Tüm düşmanlar bunları kazanır:</gl><br>Tüm hasarlar <bl>+4</bl><br>Tüm dirençler <bl>+20%</bl><br><gl>Bir kahraman bir "Büyü" oynadığında,</gl> negatif etki alır <rd>5</rd><i=dark> <rd>3</rd><i=insane>

customSubZero=<gl>Tüm düşmanlar bunları kazanır:</gl><br>Tüm hasarlar <bl>+2</bl><br>bağışıklık <i=chill><i=slow><br><gl>-Her iki turda bir-</gl><br>Tüm düşmanlara <crd=freezecorruption,1> ekle.
customSubZeroA=<gl>Tüm düşmanlar bunları kazanır:</gl><br>Tüm hasarlar <bl>+2</bl><br>bağışıklık <i=chill><i=slow><br><gl>-Her iki turda bir-</gl><br>Tüm düşmanlara <crd=freezecorruption,1> ekle.
customSubZeroB=<gl>Tüm düşmanlar bunları kazanır:</gl><br>Tüm hasarlar <bl>+3</bl><br>bağışıklık <i=chill><i=slow><br><gl>-Her iki turda bir-</gl><br>Tüm düşmanlara <crd=freezecorruption,1> ekle.
customSubZeroRare=<gl>Tüm düşmanlar bunları kazanır:</gl><br>Tüm hasarlar <bl>+4</bl><br>bağışıklık <i=chill><i=slow><br><gl>-Her iki turda bir-</gl><br>Tüm düşmanlara <crd=freezecorruption,1> ekle.

customRevenge=<gl>Tüm düşmanlar bunları kazanır:</gl><br>Tüm hasarlar <bl>+2</bl><br>bağışıklık <i=bleed><br><gl>Bir kahraman bir "Saldırı" oynadığında,</gl> Tüm düşmanlar bunları kazanır *** <bl>3</bl><i=fury> 
customRevengeA=<gl>Tüm düşmanlar bunları kazanır:</gl><br>Tüm hasarlar <bl>+2</bl><br>bağışıklık <i=bleed><br><gl>Bir kahraman bir "Saldırı" oynadığında",</gl> Tüm düşmanlar bunları kazanır <bl>4</bl><i=fury>
customRevengeB=<gl>Tüm düşmanlar bunları kazanır:</gl><br>Tüm hasarlar <bl>+3</bl><br>bağışıklık <i=bleed><br><gl>Bir kahraman bir "Saldırı" oynadığında,</gl> Tüm düşmanlar bunları kazanır <bl>5</bl><i=fury>
customRevengeRare=<gl>Tüm düşmanlar bunları kazanır:</gl><br>Tüm hasarlar <bl>+4</bl><br>bağışıklık <i=bleed><br><gl>Bir kahraman bir "Saldırı" oynadığında,</gl> Tüm düşmanlar bunları kazanır <bl>6</bl><i=fury>

customBurningWeapons=<gl>Tüm düşmanlar bunları kazanır:</gl><br>Tüm hasarlar <bl>+1</bl><br><i=fire> dirençli <bl>+15%</bl><br><gl>Bir düşman hasar verdiğinde,</gl> bu efekti uygular: <rd>1</rd><i=burn>
customBurningWeaponsA=<gl>Tüm düşmanlar bunları kazanır:</gl><br>Tüm hasarlar <bl>+2</bl><br><i=fire> dirençli <bl>+20%</bl><br><gl>Bir düşman hasar verdiğinde,</gl> bu efekti uygular: <rd>2</rd><i=burn>
customBurningWeaponsB=<gl>Tüm düşmanlar bunları kazanır:</gl><br>Tüm hasarlar <bl>+2</bl><br><i=fire> dirençli <bl>+25%</bl><br><gl>Bir düşman hasar verdiğinde,</gl> bu efekti uygular: <rd>3</rd><i=burn>
customBurningWeaponsRare=<gl>Tüm düşmanlar bunları kazanır:</gl><br>Tüm hasarlar <bl>+3</bl><br><i=fire> dirençli <bl>+30%</bl><br><gl>Bir düşman hasar verdiğinde,</gl> bu efekti uygular: <rd>4</rd><i=burn>

customPutrefaction=<gl>Tüm düşmanlar bunları kazanır:</gl><br>Tüm hasarlar <bl>+2</bl><br>bağışıklık <i=dark><i=decay><br><gl>Bir düşman hasar verdiğinde,</gl> bu efekti uygular: <rd>2</rd><i=dark><rd>1</rd><i=decay>
customPutrefactionA=<gl>Tüm düşmanlar bunları kazanır:</gl><br>Tüm hasarlar <bl>+2</bl><br>bağışıklık <i=dark><i=decay><br><gl>Bir düşman hasar verdiğinde,</gl> bu efekti uygular: <rd>3</rd><i=dark><rd>1</rd><i=decay>
customPutrefactionB=<gl>Tüm düşmanlar bunları kazanır:</gl><br>Tüm hasarlar <bl>+3</bl><br>bağışıklık <i=dark><i=decay><br><gl>Bir düşman hasar verdiğinde,</gl> bu efekti uygular: <rd>3</rd><i=dark><rd>2</rd><i=decay>
customPutrefactionRare=<gl>Tüm düşmanlar bunları kazanır:</gl><br>Tüm hasarlar <bl>+4</bl><br>bağışıklık <i=dark><i=decay><br><gl>Bir düşman hasar verdiğinde,</gl> bu efekti uygular: <rd>4</rd><i=dark><rd>2</rd><i=decay>

customHexproof=<gl>Tüm düşmanlar bunları kazanır:</gl><br>Max HP <bl>+15</bl><br>Tüm hasarlar <bl>+2</bl><br><gl>-Her tur-</gl><br>Elde et <bl>5</bl><i=buffer>
customHexproofA=<gl>Tüm düşmanlar bunları kazanır:</gl><br>Max HP <bl>+20</bl><br>Tüm hasarlar <bl>+2</bl><br><gl>-Her tur-</gl><br>Elde et <bl>6</bl><i=buffer>
customHexproofB=<gl>Tüm düşmanlar bunları kazanır:</gl><br>Max HP <bl>+25</bl><br>Tüm hasarlar <bl>+3</bl><br><gl>-Her tur-</gl><br>Elde et <bl>7</bl><i=buffer>
customHexproofRare=<gl>Tüm düşmanlar bunları kazanır:</gl><br>Max HP <bl>+30</bl><br>Tüm hasarlar <bl>+4</bl><br><gl>-Her tur-</gl><br>Elde et <bl>8</bl><i=buffer>

customHeavyWeaponry=<gl>Tüm düşmanlar bunları kazanır:</gl><br>Tüm hasarlar <bl>+3</bl><br>bağışıklık <i=vulnerable><br><gl>Bir düşman hasar verdiğinde,</gl> bu efekti uygular: <rd>1</rd><i=vulnerable><rd>1</rd><i=slow>
customHeavyWeaponryA=<gl>Tüm düşmanlar bunları kazanır:</gl><br>Tüm hasarlar <bl>+4</bl><br>bağışıklık <i=vulnerable><br><gl>Bir düşman hasar verdiğinde,</gl> bu efekti uygular: <rd>2</rd><i=vulnerable><rd>1</rd><i=slow>
customHeavyWeaponryB=<gl>Tüm düşmanlar bunları kazanır:</gl><br>Tüm hasarlar <bl>+4</bl><br>bağışıklık <i=vulnerable><br><gl>Bir düşman hasar verdiğinde,</gl> bu efekti uygular: <rd>2</rd><i=vulnerable><rd>2</rd><i=slow>
customHeavyWeaponryRare=<gl>Tüm düşmanlar bunları kazanır:</gl><br>Tüm hasarlar <bl>+5</bl><br>bağışıklık <i=vulnerable><br><gl>Bir düşman hasar verdiğinde,</gl> bu efekti uygular: <rd>2</rd><i=vulnerable><rd>2</rd><i=slow>

customThornProliferation=<gl>Tüm düşmanlar bunları kazanır:</gl><br>Max HP <bl>+15</bl><br>Tüm hasarlar <bl>+2</bl><br><gl>Bir kahraman kart oynadığında,</gl> rastgele bir düşman bunu elde eder: <rd>1</rd><i=thorns>
customThornProliferationA=<gl>Tüm düşmanlar bunları kazanır:</gl><br>Max HP <bl>+25</bl><br>Tüm hasarlar <bl>+2</bl><br><gl>Bir kahraman kart oynadığında,</gl> rastgele bir düşman bunu elde eder: <rd>2</rd><i=thorns>
customThornProliferationB=<gl>Tüm düşmanlar bunları kazanır:</gl><br>Max HP <bl>+35</bl><br>Tüm hasarlar <bl>+3</bl><br><gl>Bir kahraman kart oynadığında,</gl> rastgele bir düşman bunu elde eder: <rd>2</rd><i=thorns>
customThornProliferationRare=<gl>Tüm düşmanlar bunları kazanır:</gl><br>Max HP <bl>+45</bl><br>Tüm hasarlar <bl>+4</bl><br><gl>Bir kahraman kart oynadığında,</gl> rastgele bir düşman bunu elde eder: <rd>3</rd><i=thorns>

innate=Doğuştan
vanish=Yok olur
frail=Kırılgan
mitigate=Yatıştır
stanzai=Mısra I
stanzaii=Mısra II
stanzaiii=Mısra III
chain=Zincirleme
dispel=Arındır
jump(bonus%)=X Defa atla (bonus%)
overcharge=Aşırı yükleme
overchargeAcronym=AY
purge=Kaldır
repeat=X Defa tekrarla
repeatupto=X Defaya kadar tekrarlanabilir.
bless=Kutsal
block=Blok
buffer=Güçlendirici
courage=Cesaret
energize=Enerjilendir
evasion=Kaçınma
fast=Hız
fortify=Takviye
fury=Hiddet
haste=Çabukluk
inspire=İlham
insulate=İzolasyon ***
invulnerable=Dokunulmaz
powerful=Kuvvetli
regeneration=Rejenerasyon
reinforce=Çeviklik
sharp=Keskinlik
shield=Kalkan
stanza=Mısra
stealth=Gizlilik
taunt=Kışkırtma
thorns=Dikenler
vitality=Zindelik
bleed=Kanama
burn=Yanma
chill=Üşüme
crack=Çatlak
dark=Karanlık
daze=Sersemlik
decay=Yıpranma
disarm=Etkisiz
doom=Doom
fatigue=Yorgunluk
paralyze=Felç
insane=Delilik
mark=Hedef
poison=Zehir
sanctify=Kutsama
shackle=Zincir
sight=Görüş
silence=Susturma
slow=Yavaşlık
spark=Kıvılcım ***
stress=Stress ***
vulnerable=Kırılgan
weak=Zayıflık
wet=Islaklık
transfer=Aktarım
cards=Kartlar
challenge=Mücadele
items=Eşyalar
pet=Evcil hayvan
pets=Evcil hayvanlar
petShopWarning=** Sadece 1 evcil hayvan sahiplenebilirsiniz.
ifUnlockSigils=Unlocking content will reward you with sigil points. Use those points to increase the power of your favorite cards. ***
challengeSelection=Mücadele kart seçimi
challengeSelectionIntro=Her zaman en fazla sinerjiye sahip paketleri seçmeye çalış ve enerji maliyetlerini unutma.
challengeReroll=Paketleri yenile
challengeRound=Round
challengeRoundPerks=Seçilen Yetenekler
challengeSelectionPerk=Mücadele Yetenek seçimi
challengeSelectionPerkIntro=Kartlarınızı seçtikten sonra, kahramanınıza atanacak 4 adet Yetenek seçmelisiniz.
challengeEnergy=Ortalama enerji maliyeti
rankProgress=Rank {0}
rankTier=Seviye {0}
rankPointsAvailable=<sprite name=perk>Mevcut puanlar
rankPointsHowto=Yetenek, kahramanlarınıza atayabileceğiniz farklı bir bonus türüdür. Maceralarınızın sonunda atayabilmeniz için Yetenek puanları alacaksınız. ***
rankPointsHighest=Karakterleriniz için mevcut olan Yetenek puanlarının sayısı, <color=#F1D2A9>en yüksek karakterinizin rütbe seviyesine</color> bağlıdır
rankPerkPoints=Yetenek puanı sayısı {0} 
rankPerkPointsGain=Yeni bir oyuna başlarken kahramanlara Yetenek puanları atayabilirsiniz.
rankPerkPress=Perk atamak için tıklayın
rankPerkNotEnough=Yeterli puan yok
rankDescription0=Başlangıç öğesi (mavi)
rankDescription1=Yeni kart arkası
rankDescription2=Başlangıç kartı (mavi)
rankDescription3=Yeni kostüm
rankDescription4=Yetenek kartları (mavi)
rankDescription5=Yeni kart arkası
rankDescription6=Başlangıç öğesi (sarı)
rankDescription7=Yeni kostüm
rankDescription8=Başlangıç kartı (sarı)
rankDescription9=Yeni kart arkası
rankDescription10=Yetenek kartları (sarı)
rankLevelDescrition=Her karakter bir maceradan sonra puan kazanacaktır. Her yeni rütbe ile karakter yeni özelliklerin kilidini açacabilecektir.
cantModifyPerkMP=Bir oyuna başladıktan Perk puanlarını değiştiremezsiniz.
perkNone=Bu karakterin bu oyun için herhangi bir aktif Perkı yok
perkAuraDescription=Uyguladığın yük miktarı {0}
skinRequiredRankLevel=Bu kostümü kullanmak için karakterinizin şu özelliklere sahip olması gerekir:<br> Rütbe Seviyesi {0}
requiredAdventureComplete=Macera modunu tamamlamanız gerekmektedir.
requiredAdventureLevel=Macera modunu {0} Zorluk seviyesinde tamamlamanız gerekmektedir.
requiredObeliskComplete=Dikilitaş Mücadelesi modunu tamamlamanız gerekiyor.
requiredObeliskLevel=Dikilitaş Mücadelesi modunu {0} Zorluk seviyesinde tamamlamanız gerekmektedir.
senenthia=Senenthia Krallığı
velkarath=Velkarath Dağları
aquarfall=Aquarfall Bataklığı
theHatch=Ambar ağzı ***
spiderLair=Örümcek İni
theVoid=Void ***
act0Intro=Nasıl olduğunu mu merak ediyorsun? Her şey prensesin 16. doğum gününde başladı. Herkes avluda toplanmış, merakla onu bekliyordu. Büyücü Akademisine kabul edilecekti, bu kabul edilen kişi için gerçek bir onurdu(Ve onun bu iş için bahşedilmiş gerçek bir yeteneği vardı).<br><br> Bir anda, prensesin odasından bir patlama oldu ve ardından Senenthia krallığını kasıp kavuran bir enerji patlaması yaşandı. Kraliyet muhafızları kalenin her köşesini araştırdılar ama ne ondan ne de saray büyücüsü ve kralın başdanışmanı Lord Hanshek'ten hiçbir iz bulamadılar<br><br>. Kral, krallığın dört bir yanına askerleri arama yapmaları için yolladı ama çabaları boşa çıktı. Kralın duyduğu son şey, kızının izinin Eski Orman'ın derinliklerinde, yüzyıllardır uykuda olan kadim dikilitaşın yakınlarında kaybolduğuydu...<br><br>Çaresiz kalan kral, bir kraliyet fermanı yayınlayarak prensesi sağ salim eve getiren herkesi ödüllendireceğini ilan etti. Haber krallıkta hızla yayıldı. Birçok maceracı grubu ormana girmeye ve prensesi bulmak için dikilitaşı araştırmaya hazırlandı.<br><br>Bu, o gruplardan birinin hikâyesi.
act1Intro=Grup dikilitaşın karşısına geçti ve bir anda kendilerini Senenthia ormanından çok uzakta, başka bir yerde buldular.<br><br>Böylece dikilitaş'ın gizemlerinden biri ortaya çıkmış oldu: Eski zamanlarda dikilitaş bir ulaşım aracı olarak kullanılıyordu, çünkü bu topraklara karayoluyla ulaşmak aylar alırdı.<br><br>Grup, prenses ve Lord Hanshek'in buradan geçtiğine dair işaretler aradı... ama şansları yaver gitmedi. Uzun zamandır kimse buraya gelmemiş gibiydi.<br><br>Neyse ki ufukta başka bir dikilitaş olduğunu gördüler ve o da aktif görünüyordu. Artık tek umutları oraya ulaşmak ve şanslarını başka bir bölgede denemekti.
act2Intro=Grup nihayet ikinci dikilitaştan da geçti. Oraya vardıklarında, prensesin ya da Lord Hanshek'in orada olduğuna dair bir işaret aradılar. Bu kez vardıkları noktadan uzaklaşan iki çift ayak izi buldular, izler bir kaç günlük duruyordu.<br><br>Grup, nereye gittiklerini gerçekten bilmeseler de, sonunda onların peşinden gitmek için doğru yoldaydı.<br><br>Grup ufka doğru baktığında başka bir dikilitaş gördü. O anda, rünleri okuduklarında diğer iki dikilitaşın parladığı gibi ufuktaki dikilitaş da parlak bir şekilde parladı.<br><br>O anda Lord Hanshek ve prensesin dikilitaştan yeni geçtiklerini ve yeterince hızlı olurlarsa onları yakalayabileceklerini fark ettiler.
act3Intro=Kısım 4 Intro (metinler işleniyor)
actEndGame=Tebrikler! Oyunu normal zorluk seviyesinde tamamladınız.<br><br>Zorluk seviyelerinin kilidiniz açtınız. Artık oyunun zorluğunu artırabilecek ve her dövüşte rastgele düşmanlara sahip olmak gibi tercihlerinizi ayarlayabileceksiniz.<br><br>Ayrıca, zorluk seviyelerinde yeni yükseltilmiş eşyalar ortaya çıkar. Bu eşyalar normal eşyaların çok daha güçlü versiyonlarıdır. Her zorluk seviyesi, bu öğelerin ve yükseltilmiş kartların ortaya çıkma olasılığını artırır.<br><br>Umarız oyunu beğenmişsinizdir. Daha yapacak çok şey var! Saygılarımla, Adam, Javier ve Juanjo (Ve çevirmen :*).
goldDescription=Altın: Ekipman satın almak, kartları kaldırmak ve bazı etkinliklerde görevleri tamamlamak için kullanılır
dustDescription=Kristaller: Kart üretmek ve dönüştürmek için kullanılır
supplyDescription=Materyaller: Bir kasabanın binalarını ve hizmetlerini yükseltmek için kullanılır<br>(Maks. 500)
corruptionReward=Ödül
corruptionAltarUpgrade=Grup, <color=#E0A44E>sihirli demirhane</color>'yi kullanma hakkı kazanır.
corruptionGainGold=Grup bunları kazanacak: <br><sprite name=gold> {0}  <sprite name=dust> {1} 
corruptionGainGold2=Grup bunları kazanacak: <br><sprite name=gold> {0}  <sprite name=dust> {1}  <sprite name=supply> {2}
corruptionRemoveCard=Her karakter desteden bir tane ücretsiz <color=#E0A44E>bir tane kart</color> kaldırabilecek.
corruptionRemoveCard2=Her karakter desteden bir tane ücretsiz <color=#E0A44E>iki tane kart</color> kaldırabilecek.
corruptionRareShop=Grup, <color=#E0A44E>nadir ekipman marketine</color> erişim hakkı kazanacak.
corruptionRareShopDiscount=Grup, <color=#E0A44E>nadir ekipman marketine</color> erişim hakkı kazanacak. (%30 indirimle birlikte).
corruptionRandomCardUpgrade=Her bir karakter için rastgele basit bir kart <color=#E0A44E>yükseltilecek</color>.
corruptionHeal20=Grup savaş sonunda maksimum canının <color=#34FF46>%30'u kadar iyileşecek</color>.
corruptionHeroFreeCard={0} ücretsiz <color={1}>"{2}"</color> kartını alacak.
corruptionFreeCardUpgrade=Her karakter ücretsiz <color=#E0A44E>kart yükseltmesi</color> kazanacak.
corruptionExoticShop=Grup, <color=#E0A44E>egzotik ekipman market</color>'ine erişim kazanacak.
corruptionExoticShopDiscount=Grup, <color=#E0A44E>egzotik ekipman market</color>'ine erişim kazanacak. (%30 indirimle birlikte).
corruptionIncreasedQuality=Savaş sonunda <color=#E0A44E>kart ödülleri̇ni̇n ni̇teli̇ği̇ni ve mi̇ktarını</color> arttır.
corruptionRewardScore=(skor: +{0})
corruptionTitle=<sprite name=corruption>Obelisk Corruption ***
corruptionDesc=Dikilitaşın etkisi bu bölgedeki canavarları güçlendiriyor. Zorluğu arttırmak ve ek ödüller kazanmak için onlarla güçlendirme etkileri altında savaşmayı seçebilirsiniz.
corruptionAccept=Meydan okumayı kabul ediyor musun?
corruptionChoose=Bu ödüllerden birini seç
corruptionSelect=Meydan okumayı kabul etmeden önce bir ödül seçmelisiniz.
townUpgrades=<sprite name=supply> Kasaba yükseltmeleri
//////////////////////////////////////////// ***
townUpgrade_1_1=<c>Yaygın kartlar</c>'ın  maks üretim adedini 2'ye çıkar.
townUpgrade_1_2=<c>Üretim maliyeti</c>'ni düşür. (toplamda %15). ***
townUpgrade_1_3=<c>Sıradışı kartlar</c>'ın maks üretim adedini 2'ye çıkar.
townUpgrade_1_4=<c>Nadir kartlar</c>'ın üretimine başlangıç kasaba da izin ver. 
townUpgrade_1_5=<c>Üretim maliyeti</c>'ni düşür. (toplamda %30). ***
townUpgrade_1_6=<c>Destansı kartlar</c>'ın üretimine ikinici kasaba da izin ver.

townUpgrade_2_1=Kartların <c>dönüştürme maliyeti</c>'ni düşür. (toplamda %25). 
townUpgrade_2_2=Kartların <c>yükseltme maliyeti</c>'ni düşür. (toplamda %15). 
townUpgrade_2_3=Kartların <c>dönüştürme maliyeti</c>'ni düşür. (toplamda %50). 
townUpgrade_2_4=Kartların <c>yükseltme maliyeti</c>'ni düşür. (toplamda %30). 
townUpgrade_2_5=Kart dönüştürmeyi <c>ücretsiz</c> yap.
townUpgrade_2_6=Kartların <c>yükseltme maliyeti</c>'ni düşür. (toplamda %50).

townUpgrade_3_1=Başlangıç kasabada kart çıkarmayı <c>ücretsiz</c> yap.
townUpgrade_3_2=<c>Negatif etkileri kaldırma</c> maliyetini düşür. (toplamda %15).
townUpgrade_3_3=<c>Kart kaldırma</c> maliyetini düşür. (toplamda %25).
townUpgrade_3_4=<c>Negatif etkileri kaldırma</c> maliyetini düşür. (toplamda %30).
townUpgrade_3_5=<c>Kart kaldırma</c> maliyetini düşür. (toplamda %50).
townUpgrade_3_6=İkinci kasabada kart çıkarmayı <c>ücretsiz</c> yap.

townUpgrade_4_1=<c>Kehanet turları</c>'nın maliyetini düşür. (toplamda %10).
townUpgrade_4_2=<c>Basic divination</c> unlocked in the starting town.
townUpgrade_4_3=<c>Kehanet turları</c>'nın maliyetini düşür. (toplamda %25).
townUpgrade_4_4=<c>İleri Düzey Kehanet turu</c>'nun kilidini ikinci kasaba için aç.
townUpgrade_4_5=<c>Kehanet turları</c>'nın maliyetini düşür. (toplamda %40)
townUpgrade_4_6=<c>İleri Düzey Kehanet turu</c>'nun kilidini başlangıç kasabası için aç.

townUpgrade_5_1=Eşya dükkanında <c>eşyaları yenile</c> özelliğini aç.
townUpgrade_5_2=Eşya dükkanındaki <c>Eşyaların maliyeti</c>'ni düşür. (toplamda %15). 
townUpgrade_5_3=Eşya dükkanındaki eşyaların <c>nadirliğini</c> arttır.
townUpgrade_5_4=Eşya dükkanındaki <c>eşyaları yenileme maliyeti</c>'ni düşür. (toplamda %50).
townUpgrade_5_5=Eşya dükkanındaki <c>Eşyaların maliyeti</c>'ni düşür. (toplamda %30). 
townUpgrade_5_6=Eşya dükkanındaki eşyaların <c>nadirliğini</c> arttır.

townUpgrade_6_1=<c>Currency retention</c> at the end of a game increased (10% total).
townUpgrade_6_2=Eşya dükkanındaki <c>hayvan dükkanı</c>'nın kilidini aç.
townUpgrade_6_3=<c>Currency retention</c> at the end of a game increased (20% total).
townUpgrade_6_4=Başlangıç kasabasından 1 adım uzak olan <c>karavan noktası</c>'nın kilidini aç.
townUpgrade_6_5=<c>Currency retention</c> at the end of a game increased (30% total).
townUpgrade_6_6=Unlock the ability to <c>sell supplies</c> for gold and shards.

townRequired=<color=#FFF>[Requires]</color>  {0} more supplies spent. ***
townAssignWarning=Bu yükseltmeyi almak istiyor musun? <color=#AAAAAA>Bu işlem geri alınamaz.</color>
rerollButton=Eşyaları yenile {0}
rerollButtonCostSP=Eşyaları yenileme maliyeti her yeni kısımda artar. Satın alınmış eşyalar tekrar gelmez.
rerollButtonCostCoop=Toplam eşya yenileme maliyeti kontrol ettiğiniz karakterlere bağlıdır ve her yeni kısımda artar. Satın alınmış eşyalar tekrar gelmez.
rerollWarning=(Sadece bir tane kullanılabilir)
helpDeck=Deste
helpCasted=Oyuncu Kartları ***
saveLoad=<size=+.2><sprite name=nodeDivination></size> Deste Kaydet/Yükle
saveLoadReturn=Back to Forge ***
saveLoadDes=Mevcut destenizi kaydedebilir veya daha önce kaydedilmiş olanları yükleyebilirsiniz.
save=Kaydet
inputSaveName=Bu deste için isim girin
emptySave=<boş slot>
decks=Desteler
cardsNum=({0} kart)
savedDecks=Kaydedilmiş desteler
savedDeckDeleteConfirm=Bu desteyi silmek istediğinden emin misin?
craftDeck=Deste üret
craftWillCost=Bu desteyi üretmenin maliyetli:
craftCant=Bu desteyi üretemezsin.
craftDeckNeed=Kayıtlı bir deste oluşturmak için tüm kartların Sihirli Demirhanede mevcut olması gerekir.<br><br>Eğer ki destenizde <color=#FFF>Yara, Boon, Özel ya da Yükseltilmiş kart</color> varsa, <color=#F00>Desteni </color>kaydedemezsin/yükleyemezsin.
conflictPlayerChooses=Seçen {0} 
conflictPlayerWins=Zafer {0} 
ngDescription=Yüksek rütbeli Kahramanlar ve yükseltilmiş kasabalar için tasarlanmış daha zor oyun modu. Bu modda yükseltilmiş kartlar daha sık düşer.
needSteam=Across the Obelisk'i oynamak için Steam'e bağlı olmanız gerekmektedir.
desyncError=<b><color=#f88>Oops, bir şeyler ters gitti!</color></b><br><size=-6>Oyun, oyuncular arasında senkronize değil. Sorunun daha da kötüleşmesini önlemek için savaş yeniden başlatılacaktır.</size>
reloadForced=<color=#FFD78F>Savaşı yeniden başlatmak ister misin?</color><br><size=-6>Bir hata veya bug nedeniyle savaşı yeniden başlatmak istiyorsanız, lütfen Discord'umuza katılın ve düzeltebilmemiz için bildirin!</size>
comingSoon=Çok Yakında
onlyMasterCorruption=Only the master of the game can accept a corruption and its rewards. ***
onlyMasterButton=Sadece oda kurucusu butona basabilir..
easy=Kolay
average=Orta
hard=Zor
extreme=Ekstrem Zorluk
corruption=Yükseltme
versionMismatch=Oyun başlayamıyor. Oyun sürümleri farklı.
selectSupplyAmount=Satmak istediğiniz erzak miktarını seç. ***
selectGiveGold=Bu oyuncuya vermek istediğiniz altın miktarını seç.
selectGiveShards=Bu oyuncuya vermek istediğiniz kristal miktarını seç.
giveGold=Altın ver
giveShards=Kristal ver
giveGoldShards=Altın & Kristal ver
general=Genel
audio=Ses
gameplay=Oynanış
screenResolution=Ekran çözünürlüğü
fullScreen=Tam ekran
vsync=VSync
resetTutorial=Öğreticiyi sıfırla
resetTutorialDes=Bu, öğretici açıklamaları tekrar görmenizi sağlayacaktır.
resetSavedData=Hesap verilerini sıfırla
resetSavedDataDes=UYARI: Bu seçeneğin etkinleştirilmesi tüm hesap ilerlemenizi, kayıtlı oyunlarınızı, kilidi açılmış kartlarınızı vb. kaldıracaktır.
masterVolume=Ana sesler
musicVolume=Müzik sesi
effectsVolume=Efekt sesleri
ambienceVolume=Ortam sesleri
backgroundMute=Arka planda sessize al
backgroundMuteDes=Oyun ön planda değilken sesleri kapatır.
fastMode=hızlı mod
fastModeDes=Savaş hızı artar
autoEnd=Otomatik tur bitir
autoEndDes=Eğer kullanabileceğiniz bir kartınız yoksa, oyun sizin sıranızı bitirecektir.
showEffects=Efektleri göster
showEffectsDes=Savaş sırasında kart ve karakter efektlerini göster
extendedDescriptions=Genişletilmiş açıklamalar
extendedDescriptionsDes=Auralar ve lanetler için ek bilgi göster
acBackground=Efekt arka planı
acBackgroundDes=Karakterlerin efekt simgelerinin arkasında bir arka plan görüntüsü
restartCombatOption=Yenildiğinde savaşı yeniden başlat
restartCombatOptionDes=Yenildiğinde savaşı yeniden başlatmak için bir seçenek göster
enableShakeOption=Ekran sarsıntısını etkinleştir
enableShakeOptionDes=Savaşda yüksek hasar meydana geldiğinde ekran sarsılacak
currentScore=Güncel skor
synchronizing=[Senkronize ediliyor]
madnessChallengeSelect=Bir sonraki oyun için istediğiniz Zorluk seviyesini seçin (Her seviye önceki seviyenin daha da zorlaştırılmış halidir.).
madnessChallengeBeat=Bir Zorluk seviyesinde Dikilitaş Mücadelesini yenmek, bir sonraki seviyeye erişmenizi sağlayacaktır.
madness=Zorluk
madnessNumber=Zorluk {0}
madnessTitle=Zorluk seçimi
madnessDescription=Oyun için istediğiniz Zorluk seviyesini seçiniz. Ek olarak, farklı kombinasyonları aktifleştirerek Zorluk seviyesini arttırabilirsiniz.
madnessBasicInfo=Bu, oyunun temel zorluk seviyesidir. Ek zorluk kombinasyonlarını açmak için macerayı tamamlamalısın.<br><br>Yeni bir zorluk derecesi seçebilmek için, ister tek başınıza ister ortaklaşa oynayın, bir önceki zorluk derecesini tamamlamanız gerekir.
madnessBasic=<i=taunt> Canavarlar daha güçlü ve yetenekleri geliştirildi.
madnessObeliskLevel5=<sprite name=perk> Kahramanların başlangıç kartları, başlangıç eşyaları ve büyüleri mavi karta yükseltilir.
madnessObeliskLevel8=<sprite name=perk> Kahramanların başlangıç kartları, başlangıç eşyaları ve büyüleri sarı karta yükseltilir.<br><sprite name=energy> Tüm karakterler başlangıç da +1 enerji alır<br><sprite name=dice> Rastgele seed
madnessPerAct=<color=#AAA><size=-.5>(per act, respectively)</size></color>
madnessExhaust=<i=vanish> Exhaust ***
madnessSeriousInjuries=<i=bleed> Daha Ağır yaralar
madnessSeriousInjuriesDesc=Yaralanma kartları daha güçlüdür
madnessDeadlyInjuries=<i=bleed> Ölümcül yaralar
madnessDeadlyInjuriesDesc=Yaralanma kartları ölümcüldür
madnessNoChest=<i=nodeShop> Sandık Ödülleri Yok, kahraman başına {0} altın/kristal
madnessMonsterHp=<i=heart> Düşman Maks Canı: {0} {1}
madnessMonsterSpeed=<i=fast> Düşman Hızı: {0} {1}
madnessMonsterDamageTaken=<i=mitigate> Alınan Düşman hasarı: {0} {1}
madnessMonsterDamageDone=<i=slashing> Verilen Düşman hasarı: {0} {1}
madnessHeroSpeed=<i=slow> Kahraman Hızı: {0}
madnessHeroEnergy=<i=energy> Kahraman başlangıç enerjisi: {0}
madnessInfrequent=<i=cards> Mevcut nadir kartların sayısı 1 azaltıldı
madnessDisabledCards=<i=nodeUpgrade> Nadir kartlar başlangıç kasabasında devre dışı bırakılır. Destansı kartlar ikinci şehirde devre dışı bırakılır.
madnessRandomSeed=<i=dice> Forced random seed
madnessHarderEvents=<i=events> Daha zor etkinlikler
madnessReroll=<i=jewelry> Kasaba eşya dükkanı eşya yenileme sayısı 1 ile sınırlanır
madnessDoubledeath=<i=weak> Bir kahraman öldüğünde, iki "Death Door" alır
madnessNoSupplyExchange=<i=supply> Erzak alışverişi yapılamaz
madnessCorruptor0=<i=doom> Beklenmedik Doom
madnessCorruptor0Help=Savaşta, performans bonusu "Etkiliyici değil "e ulaştığında, tüm kahramanlar 2 turda onları öldüren "Doom" efektine maruz kalır.
madnessCorruptor1=<i=decay> Çöküş
madnessCorruptor1Help=Tüm kahramanlar yapılan iyileştirmede -3 ve alınan iyileştirmede <nobr>-%25</nobr> zayıflatma alır.
madnessCorruptor2=<i=bless> Sınırlandırılmış Güç
madnessCorruptor2Help=Auraların/Lanetlerin Maks. yükleri olur:<line-height=120%><br></line-height>( 50 ) Kutsal, Hedef, Yenilenme, Keskin kenar, Gizlilik, Zindelik, Islak<line-height=120%><br></line-height>( 100 ) Çatlak, Hiddet, Delilik, Kutsama, Görüş<line-height=120%><br></line-height>( 200 ) Kanama, Yanma, Üşüme, Zehir, Kalkan, Kıvılcım, Dikenler<line-height=120%><br></line-height>( 400 ) Blok
madnessCorruptor3=<i=insulate> Dirençli Düşmanlar
madnessCorruptor3Help=Tüm Düşmanlar tüm dirençlerine ek +%15 kazanır
madnessCorruptor4=<i=gold> Sefalet
madnessCorruptor4Help=Altın ve Kristal edinimi %50 oranında azalır. Ekstra indirimli eşyalar mevcut olmaz.
madnessCorruptor5=<i=powerful> Aşırı Yüklü Düşmanlar
madnessCorruptor5Help=Tüm düşmanlar kartlarının, aura veya lanet yüklerine +1 ekler.
madnessCorruptor6=<i=dice> Rastgele Savaşlar
madnessCorruptor6Help=Etkinlik dışı savaşlar rastgele olarak oluşturulur. Her rastgele savaşta, rastgele belirlenmiş bağışıklığa sahip bir "Şampiyon" canavar ortaya çıkar.
madnessCorruptor7=<i=bossIcon> Umutsuzluk
madnessCorruptor7Help=Düşmanlar, kullanabilecekleri en güçlü kartlara ve büyülere sahip olur.<line-height=120%><br></line-height>Bu seçenek, zorluğu önemli ölçüde artırır.
championMonster=Düşman Şampiyon
help=Yardım
madnessCorruptors=Ek zorluk seçenekleri kullanılabilir
madnessLevel=Zorluk seviyesi
cardCommon=Sıradan kart
cardUncommon=Sıradışı kart
cardRare=Nadir kart
cardEpic=Destansı kart
cardMythic=Efsanevi kart
common=Sıradan
uncommon=Sıradışı
rare=Nadir
epic=Destansı
mythic=Efsanevi
eventCommon=Sıradan olay
eventUncommon=Sıradışı olay
eventRare=Nadir olay
eventEpic=Destansı olay
eventMythic=Efsanevi olay
eventCharacter=Karakter olayı
cardPlayerDescription=En küçük kararlar bile kaderinizi belirler. Dikkatli olun: <color=#C59559>bu kartlar karıştırıldıktan sonra</color>, birini seçmeniz gerekecek.
chooseWisely=Akıllıca bir seçim yap
madnessHelp=<align=left><color=#FFF>Her Zorluk seviyesi, oyunu genel olarak daha zor hale getiren yeni seçenekler ekler. Bunlardan bazıları aşağıda daha ayrıntılı olarak açıklanmıştır.</color><br><br><u>Bitkinlik:</u> Destenin dönmesine neden olan bir kart kullandığınızda, Bitkinlik efekti alırsın, O tur sırasında elinize gelen herhangi bir kartın ek enerjiye mal olmasına neden olur.<br><br><u>Ciddi ve Ölümcül yaralar:</u> Bir etkinlikte başarısız olduğunuzda aldığınız yaralar daha güçlü versiyonlarla değiştirilir.<br><br><u>Sandık Ödülleri yok:</u> Önceki oyunlardan ödül sandıkları alınamaz ve başlangıç altını/kristali sınırlıdır. Bu değiştirici ile oyunun sonunda ödül sandığı alamazsınız.<br><br><u>Daha zor etkinlikler:</u> Bir etkinlikte zarlamayı geçmek için gereken sayıyı elde etmek daha zordur, etkinliğe bağlı olarak gereken sayı daha yüksek veya daha düşüktür.</align>
exhaust=<u>Bitkinlik:</u> Destenin dönmesine neden olan bir kart kullandığınızda, Bitkinlik efekti alırsın,O tur sırasında elinize gelen herhangi bir kartın ek enerjiye mal olmasına neden olur.
madnessOptionsText=ZORLUK {0} BONUS LİSTESİ
replyProbability=Başarı olasılığı:{0}
masterSelected=Oyunun kurucusu tarafından seçildi
notStack=Birikmez
notStackPlain=Yükler birikmez
searchCards=Kart ara
perksNotChallenge=Perklar ve rütbe geliştirmeleri <color=#F1D2A9>Dikilitaş ve Haftalık mücadele</color> modlarında mevcut değildir.
rightClickCard=Sağ tık <br><size=-.7>(Daha fazla bilgi)
traitAddCard=Bu kartı "{0}" elde et 
addCardInstructions=Eklenecek kartları seçin
lowerObelisk=Lower Obelisk ***
upperObelisk=Upper Obelisk
finalObelisk=Final Obelisk
notOriginalPlayers=Şu anki oyuncular oyunu yaratan oyuncularla aynı değil, bu yüzden, <color=#F3404E>nihai puan</color> skortahtasına yansatılmayacaktır.
basicDifficulty=Temel Zorluk
basicDifficultyDesc=Bu, bu oyun modunun temel zorluğudur.
dangerousMonsters=Tehlikeli Düşmanlar
dangerousMonstersDesc=Düşmanın verdiği hasar: +3
decadence=Çöküş
decadenceDesc=Tüm kahramanlarda yapılan iyileştirmeye -3, alınan iyileştirmeye <nobr>-%25</nobr> ve Zindelik kazanılan maksimum HP'nin yalnızca %50'sini iyileştirir
doubleBoons=Çifte Boons 
doubleBoonsDesc=Bir boon aldığınızda, ek bir kopya daha alın.
doubleInjuries=Çifte Yaralanma
doubleInjuriesDescBir yara aldığınızda, ek bir kopya daha alın.
elementalMonsters=Elemental Düşmanlar
elementalMonstersDesc=Düşman Ateş / Soğuk / Yıldırım dirençleri: +10%
energizedHeroes=Sinerjik Kahramanlar
energizedHeroesDesc=Kahraman başlangıç enerjisi: +1
exhaustion=Bitkinlik
exhaustionDesc=Destenin karışmasına neden olan bir kart kullandığında, Bitkinlik efekti alırsın.
fastHeroes=Hızlı Kahramanlar
fastHeroesDesc=Kahraman Hızı: +1
fastMonsters=Hızlı Düşmanlar
fastMonstersDesc=Düşmna Hızı: +1
gargantuanMonsters=Devasa Düşmanlar
gargantuanMonstersDesc=Düşman Maks Sağlık: +50%
hardcoreBosses=Zorlu Bosslar
hardcoreBossesDesc=Bosslar daha zor ve yetenekleri geliştirildi.
impedingDoom=Kaçınılmaz Doom
impedingDoomDesc=Performans Etkiliyici değil seviyesine ulaştığında tüm kahramanlar 2 "Doom "a maruz kalır.
ironcladMonsters=Demirden Düşmanlar
ironcladMonstersDesc=Düşmanların aldığı hasar: -3
lucky=Şanslı
luckyDesc=Etkinlik zarları daha kolaydır.
ludicrousSpeed=Dehşet Verici Hız
ludicrousSpeedDesc=Düşman Hızı: +3
moreChampions=Daha fazla Şampiyon
moreChampionsDesc=Haritada daha fazla Şampiyon belirir.
overchargedMonsters=Aşırı Yüklü Düşmanlar
overchargedMonstersDesc=Tüm düşman kartlarının yüklerine +1 eklenir.
poverty=Sefalet
povertyDesc=Altın ve Kristal kazanımı %30 oranında azaltıldı.
prosperity=Bereket
prosperityDesc=Altın ve Kristal kazanımı %50 oranında artırıldı.
punyMonsters=Çelimsiz Düşmanlar
punyMonstersDesc=Düşman Maks Sağlık: -25%
reinforcedMonsters=Sağlamlaştırılmış Düşmanlar
reinforcedMonstersDesc=Düşman Kesme / Küt / Delici dirençleri: +10% ***
resistantMonsters=Dirençli Düşmanlar
resistantMonstersDesc=Tüm düşman dirençleri: +15%
restrictedPower=Sınırlandırılmış Güç
restrictedPowerDesc=Auralar ve lanetlerin maksimum yük sayısı sınırı vardır.
slowHeroes=Yavaş Kahramanlar
slowHeroesDesc=Kahraman Hızı: -1
slowMonsters=Yavaş Düşmanlar
slowMonstersDesc=Düşman Hızı: -1
smartHeroes=Akıllı Kahramanlar
smartHeroesDesc=Kazanılan deneyim %50 oranında artar.
spiritualMonsters=Ruhani Düşmanlar
spiritualMonstersDesc=Canavar Kutsal / Gölge / Zihin dirençleri: +10%
tougherMonsters=Daha Sert Düşmanlar
tougherMonstersDesc=Düşmanlar daha güçlü ve yetenekleri geliştirildi.
unlucky=Şanssız
unluckyDesc=Etkinlik zarları daha zor.
vigorousMonsters=Dinç Düşmanlar
vigorousMonstersDesc=Düşman Maks Sağlık: +25%
vulnerableMonsters=Savunmasız Canavarlar
vulnerableMonstersDesc=Tüm düşman dirençleri: -15%
wealthyHeroes=Servetli Kahramanlar
wealthyHeroesDesc=Her kahraman ek 300 altın/kristal ile başlar.
weeklyModificatorsDescription=Bunlar, bu Mücadele için aktif olan oyun modifikasyonlarıdır.
incompatible=Bu sürüm ile uyumlu değil
weeklyModifiers=Haftalık modifikasyonlar.
weeklyModifiersStyled=<size=+.2><size=+.3><color=#FFF>Haftalık</color></size><br> Modifikasyonlar</size>
openCharacterStats=<sprite name=sheet> Karakter istatistiklerini aç
corruptionSacrifyDust=+{%1} şans için {0} kristal daha ödeyin
corruptionSacrifySpeed=Ek +{1}% şans için {0} Hızı feda edin
corruptionSacrifyHealth=Ek +{1}% şans için {0} Maks. sağlık puanı feda edin
corruptionSacrifyResistance=Ek +{1}% şans için tüm dirençlerde {0} değeri feda edin
cardCorruptionTitle=Kart Yükseltme
cardCorruptionDesc=Seçtiğiniz bir kartı yükseltebilir ve en güçlü versiyonuna dönüştürebilirsiniz.<br><br>Ancak bu kolay bir iş değildir. Eğer ki başarısız olursan bu durum karta zarar verecektir.<br><br>Başarı şansını fedakarlıklarla da artırabilirsin.
cardCorruptionChance=Şans
deathScreenTitle={0} Öldürüldü!
deathScreenBody=Takımınız hayatta kalırsa, toplam canınızın {0}%'ı ile dirileceksiniz, ancak hiçbir şeyin bedelsiz olmadığını ve bu damgayı hayatınızın geri kalanında taşıyacağınızı unutmayın.
crusader=crusader
devotee=devotee
friar=friar
healer=healer
heretic=heretic
justicar=justicar
mentalist=mentalist
protector=protector
saint=saint
seer=seer
shaman=shaman
zealot=zealot
aeromancer=aeromancer
cryomancer=cryomancer
enchanter=enchanter
glacier=glacier
inferno=inferno
scribe=scribe
shadowmancer=shadowmancer
sorcerer=sorcerer
tempest=tempest
witch=witch
wizard=wizard
bard=bard
bowman=bowman
explorer=explorer
fencer=fencer
hunter=hunter
ninja=ninja
plague=plague
poisoner=poisoner
reaver=reaver
rogue=rogue
scoundrel=scoundrel
skald=skald
sniper=sniper
avenger=avenger
axman=axman
brawler=brawler
commander=commander
defender=defender
destroyer=destroyer
gladiator=gladiator
guardian=guardian
marauder=marauder
swordman=swordman
warlord=warlord
pyromancer=pyromancer
ranger=ranger
elementalist=elementalist
berserker=berserker
sentinel=sentinel
mercenary=mercenary
voodoo_witch=voodoowitch
prophet=prophet
priest=priest
cleric=cleric
assassin=assassin
loremaster=loremaster
voodoowitch=Voodoo Witch
warden=Warden
archer=Archer
deathknight=Death Knight
inquisitor=Inquisitor
minstrel=Minstrel
paladin=Paladin
valkyrie=Valkyrie
warlock=Warlock
AdventureCompletedCardback=Macera
AdventureCompletedMadnessCardback=Zorluk
ObeliskCompletedCardback=Dikilitaş
ObeliskCompletedMadnessCardback=Dementia
preturnEffects=Tur başındaki etkiler
postturnEffects=Tur sonundaki etkiler
characterDies=Karakter ölür
followTheLeader=Lideri takip et
followTheLeaderDesc=Oyunun kurucusuyla aynı seçenekleri otomatik olarak seçeceksiniz (harita ilerlemesi, etkinlik yanıtları, vb.).
magnusPet1=Beni okşamayı kes... Beni utandırıyorsun!
magnusPet2=...Grrr... Mmm... Bir daha yapabilir misin?
conflictTitle=<sprite name=cardrandom>Anlaşmazlık Çözüm Yolu
conflictDescription=Oyuncular arasında bir anlaşmazlık olduğunda, kimin kazanacağına karar vermek için bir anlaşmazlık çözüm zarı atılması gerekir. Birden fazla beraberlik durumunda (3), kazanan rastgele seçilecektir.
conflictButton0=En düşük kart
conflictButton1=2'ye en yakın kart
conflictButton2=En yüksek kart
noEnergy=Enerji Yok
physical=Fiziksel
elemental=Elemental
mystical=Mistik
confirmPerks=Perk atamasını onayla
cardsStealAuras={0} Aurasını çal
steal=Çal
previousRequired=Previous node required ***
usedPoints=Kullanılan puanlar {0}
export=Dışa Aktar
import=İçe Aktar
pressForCopyPaste=Bu Perk düzenlemesi için paylaşım kodu
pressForImportTree=İçe aktarma kodunu yazın veya yapıştırın
importPerkTreeNotPoints=Bu Perk düzenlemesini içe aktarmak için yeterli toplam Perk puanınız ({0}) yok.
invalidImportTalentTreeCode=Bu kod, bir Perk düzenlemesini içe aktarmak için geçerli değildir.
importedTree=Perk konfigürasyonu içe aktarıldı
wantOverwritePerks=Bu yuvayı yüklemek ve Perk ayarlarınızın üzerine yazmak istiyor musunuz?
loadThisPerkConf=Bu Perk konfigürasyonunu yükle ({0} kullanılmış puan)
wantExitPerks=Kaydedilmemiş değişiklikleriniz var. Perk ayarlama penceresini kapatmak istiyor musunuz?
itemInitialCurrencySingle=Başlangıç altını {0}
itemInitialShardsSingle=Başlangıç kristalleri {0}
default=Varsayılan
perkTreeDescription=Oyun başlamadan önce ve ilk kasabada (bazı kısıtlamalarla) Yeteneklerini değiştirebilirsin.<br><br>Ayrıca oyun başlamadan önce farklı Perk yapılandırmalarını kaydedebilir ve yükleyebilirsiniz.
saveSlots=Slotları Kaydet
inputConfigSaveName=Bu konfigürasyon için ad girin
savedConfigDeleteConfirm=Bu konfigürasyonu silmek istiyor musunuz?
savedConfigCant=Kaydetme yuvaları yalnızca oyun başlamadan önce kullanılabilir.
perkBarDescription=Tüm kahramanlarınız oyunu oynadıkça Perk puanları kazanacaktır.
chooseOnePerk=Aşağıdaki Yeteneklerden <u>birini</u> seçin.
slashing=Kesme /// this must have the same translate as "slash"
customMainperkPoison2b=Düşmanların üzerindeki zehir ayrıca Gölge direncini yük başına %0,3 azaltır.
customMainperkPoison2c=Düşmanların üzerindeki zehir %50 daha fazla hasar verir ancak tur sonunda tüm yüklerini kaybeder.
customMainperkDark2b=Bu kahramanın üzerindeki Karanlık 38 yükte patlar.
customMainperkDark2c=Düşmanlar üzerindeki Karanlık patlama %35 daha fazla hasar verir.
customMainperkDark2d=Düşmanların üzerindeki Karanlık yükler de tur sonunda patlar.
customMainperkThorns1a=Kahramanların üzerindeki Dikenler vurulduğunda yük kaybetmez.
customMainperkThorns1b=Bu kahramanın üzerindeki Dikenler Kutsal hasar verir.
customMainperkThorns1c=Bu kahramanın üzerindeki Dikenler, hasar vermek yerine yüklerinin %50'sini saldırgana Zehir olarak uygular.
customMainperkSanctify2b=Düşmanlar üzerindeki Kutsama, Kutsal direnci yük başına %1,5 azaltır.
customMainperkSanctify2c=Bu kahraman bir canavara Kutsama ile vurduğunda, hedefin Kutsama yüklerinin %25'ini de Kutsal hasar olarak verir.
customMainperkChill2b=Düşmanların üzerindeki Soğukluk ayrıca Künt direncini yük başına %0.3 azaltır. ***
customMainperkChill2c=Düşmanlar üzerindeki Soğukluk etkisi Hızı 4 yük başına 1 azaltır.
customMainperkChill2d=Bu kahramandaki Soğukluk, Hızı 8 yük başına 1 azaltır ve ayrıca tur sonunda 14 yük başına 1 Çeviklik verir. 
customMainperkBurn2b=Bu kahraman üzerindeki Yanma Hızı 8 yük başına 1 artırır ve Ateş direncini yük başına %0.3 azaltır.
customMainperkBurn2c=Yanma, Soğuk hasarı verir.
customMainperkVulnerable0b=Düşmanlar üzerindeki maksimum Kırılgan yükü 12'ye çıkarılır ve tur sonunda 1 azaltılır.
customMainperkVulnerable0c=Düşmanlardaki Kırılganlık yalnızca Kesici, Delici ve Keskinlik dirençlerini azaltır, ancak azalma etkisi yük başına %8'e çıkarılır. ***
customMainperkDecay1b=Düşmanlardaki Yıpranma alınan iyileştirmeyi %75 azaltır ve belirtilmediği sürece kaldırılamaz.
customMainperkDecay1c=Düşmanlardaki Yıpranma ayrıca Gölge direncini yük başına %8 azaltır.
customMainperkTaunt1b=Bu kahraman üzerindeki Kışkırtma etkisi aynı zamanda Kesme, Delme, Blund dirençlerini %10 arttırır. 
customMainperkTaunt1c=Bu kahraman üzerindeki Kışkırtma etkisi Ateş, Soğuk ve Yıldırım dirençlerini %10 arttırır.
customMainperkTaunt1d=Bu kahraman üzerindeki Kışkırtma etkisi Kutsal, Gölge, Zihin dirençlerini %10 arttırır.
customMainperkBless1a=Bless on this hero increases damage done by 1.5 per charge but no longer increases healing received. ***
customMainperkBless1b=Bless on this hero also increases healing done by 1% per charge.
customMainperkBless1c=Bless on heroes also increases Holy resistance by 0.5% per charge and does not lose charges at the end of the turn.
customMainperkVitality1a=Zindellik artık yük başına 8 maks sağlık kazandırır.
customMainperkVitality1b=Bu kahraman eğer Zindellik kazanırsa, üzerindeki Kanama kalkar.
customMainperkVitality1c=Zindellik kahramanlar üzerinde Zihin direncini yük başına %0.5 arttırır ve tur başladığında yük kaybetmez. 
customMainperkRegeneration1a=Bu kahraman üzerindeki Yenilenme aynı zamanda yanı başındaki kahramanları da iyileştirir.
customMainperkRegeneration1b=Kahramanlar üzerindeki Yenilenme yük başına iyileşmeyi %1 arttırır. 
customMainperkRegeneration1c=Kahramanlar üzerindeki Yenilenme aynı zamanda Gölge direncini %0.5 arttırır ve tur başında yük kaybetmez.
customMainperkPowerful1b=Kuvvetli efektinin bu kahraman üzerinde maksimum yükü 12 olur. Tur sonunda yük 1 azalır. 
customMainperkPowerful1c=Kuvvetli efekti bu kahraman üzerinde alınan iyileştirmeyi ve hasarı %10 arttırır. maksimum yük 3 azalır ve tüm yükler tur sonunda kaldırılır.
customMainperkEnergy2a=Eğer ki bu kahraman 6 veya daha yüksek enerjili bir kart oynarsa, 1 enerji iade edilir.
customMainperkEnergy2b=Bu kahraman 2. raunda turun başında 1 enerji kazanır. 
customMainperkEnergy2c=Bu kahraman 4. raunda turun başında 2 enerji kazanır. 
customMainperkMark1a=Bu kahraman Hedef efektine Bağışık olur.
customMainperkMark1b=Düşmanların üzerindeki İşaret, Gizliliği engellerken ve tur sonunda yükleri kaybetmez.
customMainperkMark1c=Düşmanlar üzerindeki Hedef efekti aynı zamanda Kesme direncini yük başına %0.3 azaltır.
customMainperkSight1b=Görüş efekti düşmana uygulandığında üzerindeki Gizlilik'i kaldırır ve belirtilmedikçe kaldırılamaz.
customMainperkSight1c=Yükler +3 artar. Düşman üzerindeki Görüş Güçlendirici veya bağışıklık tarafından engellenemez ama tur sonunda tüm yük kaldırılır.
customMainperkStealth1a=Kahramanlar üzerindeki Gizlilik efekti alınan iyileştirmeyi ve hasarı yük başına %25 arttırır.
customMainperkStealth1b=Bu kahraman üzerindeki Gizlilik tur başında yüklerini kaybetmez.
customMainperkStealth1c=Bu kahraman üzerindeki Gizlilik tüm dirençlerini yük başına %5 arttırır. 
customMainperkFury1b=Bu kahraman üzerindeki Hiddet yük başına hasarı %1 arttır ama artık tur sonunda Kanama uygulamaz.
customMainperkFury1c=Bu kahraman üzerindeki Hiddet yük başına hasarı %5 arttır. Kanama bu kahramana %50 daha fazla vurur ve Kanama, Güçlendirici veya bağışıklık ile önlenemez.
customMainperkBleed2c=Uyguladığın yük +2 artar. Düşman üzerindeki Kanama etkisi tur sonunda vurur ama Güçlendirici veya bağışıklık ile önlenemez. 
customMainperkSharp1a=Bu kahraman üzerindeki Keskin Kenar, Kesme hasarını yük başına 1.5 arttır ama artık Delme hasarını arttırmaz.
customMainperkSharp1b=Bu kahraman üzerindeki Keskin Kenar, Delme hasarını yük başına 1.5 arttır ama artık Kesme hasarını arttırmaz.
customMainperkSharp1c=Bu kahraman üzerindeki Keskin Kenar, tur sonunda yüklerini kaybetmez ve belirtilmediği sürece kaldırılamaz.
customMainperkStanza0a=Bu kahraman ilk turunda Mısra I kazanır.
customMainperkStanza0b=Bu kahraman üzerindeki Mısra I aynı zamanda tur sonunda 1 İlham verir.
customMainperkStanza0c=Bu kahraman Mısra III kazanamaz.
customMainperkReinforce0=Bu kahraman ilk turunda 1 Çeviklik kazanır. Çeviklik belirtilmediği sürece kaldırılamaz.
customMainperkReinforce1b=Kahramanlar üzerinde Çeviklik aynı zamanda Kesme, Delme, Blunt direncini %35 arttırır. 
customMainperkReinforce1c=Bu kahraman üzerindeki Çeviklik birikebilir ve yük başına %7 Kesme, Delme, Blunt direnci alır. Maksimum yük 8. 
customMainperkInsulate0=Bu kahraman ilk turunda 1 İzolasyon kazanır. Belirtilmediği sürece bu kahramanın üzerindeki İzolasyon kaldırılamaz.
customMainperkInsulate1b=Insulate on heroes instead increases the Fire, Cold and Lightning resistances by 35%.
customMainperkInsulate1c=Insulate on this hero can stack and instead increases the Fire, Cold and Lightning resistances by 7% per charge. Maximum charges are 8. 
customMainperkCourage0=Bu kahraman ilk tur 1 Cesaret kazanır. Ayrıca Cesaret efektleri belirtilmediği sürece kaldırılamaz.
customMainperkCourage1b=Kahramanlar üzerindeki Cesaret Kutsal, Gölge ve Zihin dirençlerini %35 arttırır.
customMainperkCourage1c=Bu kahraman üzerindeki Cesaret birikebilir ve yük başına %7 Kutsal, Gölge, Zihin direnci alır. Maksimum yük 8. 
customMainperkInspire0a=Bu kahraman turunun başında 1 İlham alır.
customMainperkInspire0b=Bu kahraman üzerindeki İlham maksimum yükü 1 olur ancak İlham tur başında 2 kart çekmeni sağlar. 
customMainperkInspire0c=Bu kahraman Stress'e karşı bağışık olur.
customMainperkInsane2b=Düşmanlar üzerindeki Delilik maksimum canlarını yük başına 2 azaltır.
customMainperkInsane2c=Kahramanlar üzerindeki Delilik Zihin direncini yük başına 0.5 düşürür ve %0.3 daha fazla hasar alırlar.
customMainperkWet1a=Düşmanlar üzerindeki Islaklık aynı zamanda yük başına Soğuk hasarını arttırır.
customMainperkWet1b=Düşmanlar üzerindeki Iskaklık yük başında Yıldırım direncini %1 düşürür ve tur sonunda yükler yok olmaz.
customMainperkWet1c=Kahramanalar üzerindeki Islaklık yük başına 3 Yanma etkisini engeller ve tur sonunda yükler yok olmaz. 
customMainperkFortify1a=Bu kahraman üzerindeki Takviye birikebilir. Ateş ve Blunt hasarı yük başına 1 artar. Maksimum yük 50. 
customMainperkFortify1b=Bu kahraman ilk turunda 1 Takviye kazanır. Takviye belirtilmediği sürece kaldırılamaz.
customMainperkFortify1c=Üzerinde Takviye olan kahramanlar tur sonunda yük başına 7 Blok kazanır. 
customMainperkSpark2b=Düşmanların üzerindeki Kıvılcım, turun başlangıcında yüklerinin %30'unu Yanıbaşındakilere Kıvılcım yükü olarak uygular. 
customMainperkSpark2c=Düşmanların üzerindeki Kıvılcım ayrıca turun sonunda 14 yük başına 1 Yavaşlatma uygular.
customMainperkCrack2b=Düşmanlar üzerindeki Çatlak ayrıca kazanılan Blok yüklerini yük başına 0,5 azaltır.
customMainperkCrack2c=Düşmanlar üzerindeki Çatlak, turun sonunda 14 yük başına 1 Kırılgan uygular.
emptySave=[boş slot]
madnessCorruptor1Help=Tüm kahramanlarda yapılan iyileştirmeye -3, alınan iyileştirmeye <nobr>-%25</nobr> ve Zindelik kazanılan maksimum sağlığın yalnızca %50'sini sağlar
faeborg=Faeborg Ormanı 
act1Intro=Grup, dikilitaşın karşısına geçti ve aniden kendilerini başka bir yerde buldu, Senenthia Ormanı'nın oldukça uzağında.<br><br>Dikilitaşın gizemlerinden birisi grup için ortaya çıkmış oldu... Eski zamanlarda dikilitaş, uzak diyarlara ulaşım için kullanılıyordu.<br><br>Prensesin ya da Lord Hanshek'in orada olduğuna dair bir işaret aradılar ve bölgeden uzaklaşan iki çift ayak izi buldular.<br><br>Grup ufka baktı ve bu bölgede aktif olan başka bir dikilitaş daha olduğunu gördü. Kuşkusuz Prenses ve Lord Hanshek'in dikilitaşların aktif hale gelmesiyle bir ilgisi vardı. Grubun bir sonraki hedefi belliydi.
act2Intro=Grup ikinci dikilitaştan geçti ve daha önce olduğu gibi prenses ve Lord Hanshek'in daha yeni bir izini buldu.<br><br>Büyük sihirli güçleriyle tanınan Senenthia kraliçesinin de birkaç yıl önce ortadan kaybolduğunu hatırladılar. Prenses bu güçleri miras almış olabilir mi? Ve Lord Hanshek bundan faydalanmayı mı amaçlıyordu?<br><br>Artık geri dönemeyecek kadar çok soruları vardı. Ne pahasına olursa olsun Lord Hanshek'e ulaşmalıydılar.<br><br>Bu bölgede, ufukta aktif bir dikilitaşın da olduğunu görünce şaşırmadılar.<br><br>Bu kez grup, acele ederlerse onlara yetişebilecekleri hissine kapıldı.
act3Intro=Dikilitaşları geçmeye alışmış olsalar da, bu seferki his biraz farklıydı.<br><br>Etraflarına baktıklarında hayretler içinde kaldılar. Sonsuz bulutlar ve antik kalıntılar etraflarında süzülüyordu... Neredeydiler? Buraya yürüyerek ya da herhangi bir normal yolla ulaşılamayacağı kesindi.<br><br>Grup büyünün ne kadar yoğun olduğunu hissedebiliyordu ve hiç şüphesiz Lord Hanshek'in dikilitaşlarla hedeflediği şey bu olmalıydı.<br><br>Ufukta bulutların üzerinde yükselen büyük bir merdiven gördüler. Lord Hanshek'in neyin peşinde olduğunu öğrenmek için grubun gitmesi gereken yer orasıydı.
actEndGame=Tebrikler! Oyunu normal zorluk seviyesinde tamamladın.<br><br>Zorluk seviyelerinin kilidini açtınız. Artık oyunun zorluğunu artırabilecek ve her dövüşte rastgele düşmanlara sahip olmak gibi tercihlerine göre uyarlayabileceksin.<br><br>Ayrıca, zorluk seviyelerinde yeni yükseltilmiş eşyalar ortaya çıkar. Bu eşyalar normal eşyaların çok daha güçlü versiyonlarıdır. Her zorluk seviyesi, bu eşyaların ve yükseltilmiş kartların ortaya çıkma şansını artırır. <br><br>Umarız oyunu beğenmişsinizdir. Daha gelecek çok şey var! Saygılarımla, Adam, Javier ve Juanjo.
cinematicIntro0=Her şey prensesin 16. doğum gününde başladı.
cinematicIntro1=Birden prensesin odasından bir enerji patlaması oldu.
cinematicIntro2=ve Senenthia krallığının 4 bir yanını sarsttı.
cinematicIntro3=Kraliyet muhafızları kalenin her köşesini araştırdı,
cinematicIntro4=ama ne ondan ne de saray büyücüsü Lord Hanshek'ten bir iz bulamadılar.
cinematicIntro5=Kral tüm krallığa askerler gönderdi ama çabaları boşa çıktı.
cinematicIntro6=Prensesin izi Eski Orman'ın derinliklerinde kayboldu,
cinematicIntro7=yüzyıllardır uykuda olan antik dikilitaşın yakınlarında...
cinematicIntro8=Çaresiz kalan kral, bir kraliyet kararnamesi ilan etti.
cinematicIntro9=Prensesi sağ salim eve getirene ödül verileceği duyuruldu.
cinematicIntro10=Haber tüm krallığa hızla yayıldı.
cinematicIntro11=Birçok maceracı grubu dikilitaşı araştırmak için hazırlandı.
cinematicIntro12=Bu, o gruplardan birinin hikayesi.
cinematicOutro0=Bu beni nasıl kurtardıklarının hikayesi...
selectLanguage=Dil
selectLanguageChanged=Dil değişiklikleri oyunu bir sonraki başlatışında geçerli olacak.
steamErrorConnect=Steam API'si başlatılamadı. Lütfen Steam'i yeniden başlat ve tekrar dene.
immortal=Ölümsüzlük
emotes=İfadeler
selectTheTarget=Hedef seç
credits=Credits
gameDeveloper=Game developer
gameDesigner=Game designer
gameArtDirector=Art director
gameLeadArtist=Lead artist
gameSeniorArtis=Senior artist
effects=Effects
paradoxPublishing=Paradox Publishing
collaborations=Collaborations
music=Music
sound=Sound
art=Art
iconArt=Icon art
specialThanks=Özel teşekkür
huntress=huntress
reaper=reaper
creditsAnd={0} ve daha iyi bir oyun yapmamız için bize her gün yardımcı olan herkese teşekkür ederiz.
partyMembersWithPerk=Bu özelliğe sahip parti üyeleri:
multiplayerNotWorkLowerVersion=Çok oyunculu oyun {0}'dan düşük sürümler için çalışmıyor
pleaseUpdate=Lütfen oyununuzu güncelleyin
crackedVersion=Birisi oyunun korsan bir versiyonunu kullanıyor. Oyun şimdi kapanacak.
lastPlayedCard=Son oynanan kart
restart=Yeniden Başlat
restartInfo=Yapılan tüm seçimleri geriye alacaksın ve süreç yeniden başlayacak
restartClient={0} geriye dönüş istiyor. Bu ekranı yeniden başlatmak istiyor musun?
exhaust=<u>Exhaust:</u> Sıra sendeyken destenin yeniden karışmasına neden olduğunda, Bitkinliğe maruz kalırsın ve sıra sonuna kadar eline çekiliş destenden, ıskarta destenden veya yok olmuş destenen eklenen tüm yeni kartların maliyeti 1 artar. Bitkinlik birikebilir, kaldırılamaz ve tur sonunda kaldırılır.
madnessCorruptor3Help=Tüm canavarlar tüm dirençlerine ek +%10 kazanır. Canavarlar üzerindeki maksimum Kırılgan yükü 6 olur.
resistantMonstersDesc=Tüm canavarlar tüm dirençlerine ek +%10 kazanır. Canavarlar üzerindeki maksimum Kırılgan yükü 6 olur
customMainperkPowerful1b=Bu kahramanın Kuvvetli efekti maksimum yük 2 artar. Kuvvetli efekti sıra sonunda 1 azalır.
customMainperkVulnerable0b=Düşmanlar üzerindeki maksimum Kırılgan yükü 1 artar. Bunun yerine yükler tur sonunda 1 azalır.
customMainperkReinforce0=Bu kahraman savaşın başında 1 Çeviklik kazanır. Belirtilmediği sürece bu kahramanın üzerindeki Çeviklik kaldırılamaz.
customMainperkInsulate0=Bu kahraman savaşın başında 1 Yalıtım kazanır. Belirtilmediği sürece bu kahramanın üzerindeki yalıtım kaldırılamaz.
customMainperkCourage0=Bu kahraman savaşın başında 1 Cesaret kazanır. Belirtilmediği sürece bu kahramanın cesareti kaldırılamaz.
customMainperkBurn2c=Düşmanlar üzerindeki Yanma, Soğuk hasarı verir ayrıca Ateş ve Soğuk direncini yük başına %0,3 azaltır.
customMainperkBurn2d=Hedefin iki veya daha az laneti varsa (Yanma dahil) düşmanlardaki Yanma iki kat hasar verir
customMainperkSharp1d=Kahramanlar üzerindeki Keskinlik ayrıca Gölge hasarını yük başına 1 artırır.
customMainperkStanza0a=Kahramanlar üzerindeki Mısra, yalnızca Zihin hasarı yerine Tüm hasarları artırır.
abortMultiplayerPlayer=Bir oyuncunun bağlantısı kesildi. Oyuncu yeniden katıldığında, oyuna son kayıt noktasından devam edebileceksiniz.
abortMultiplayerMaster=Oyun kurucusunun bağlantısı kesildi. Oyun şimdi kapanacak. Yeni bir oyun oluşturabilir ve son kayıt noktasından yükleyebilirsin. 
errorSteamAuth=Steam kimlik doğrulama hatası oluştu. Lütfen daha sonra tekrar dene.
lfmRoom=Oyuncu arıyor
joinOldGame=Oyunla bağlantın kesilmiş gibi görünüyor. Eski oyununa yeniden katılmayı denemek ister misin?
darkestnight=Karanlık Gece
darkestnightDesc=Karanlık yükler ayrıca tur sonunda da patlar.
challengeSpooky=Ürkütücü Gece
customSpookyNight=<gl>Tüm düşmanlar bunları kazanır:</gl><br>Tüm hasarlar <bl>+1</bl><br><gl>-Her tur-</gl><br>Tüm kahramanlar <rd>3</rd> zarar görür<i=dark>
customSugarRush=<gl>Tüm düşmanlar bunları kazanır:</gl><br>Tüm hasarlar <bl>+2</bl><br><gl>-Her tur-</gl><br>Her kahraman destesine <crd=candy,1> karıştırır.
customDeathGrip=<gl>Tüm düşmanlar bunları kazanır:</gl><br>Tüm hasarlar <bl>+2</bl><br><gl>-Her tur-</gl><br>Rastgele bir karaktere <rd>1<i=shackle> 3</rd><i=dark> uygular. 
itemApplyRandom=Rastgele bir karaktere {0} uygula
recommended=Tavsiye edilen
cardsReduceAura=Aura yüklerini {0}% oranında azalt
cardsIncreaseCurse=Lanet yüklerini {0}% arttır
cardsIncreaseAura=Aura yüklerini {0}% oranında arttır
transmute=Değiştir
transform=Dönüştür
upgrade=Geliştir
cardbackDLCSpooky=Şaka
cardbackWeeklyHalloween=Şeker
requiredDLC=DLC'ye sahip olmanız gerekir <nobr>"<color=#FFF>{0}</color>"</nobr>
requiredWeekly=Haftalık Mücadeleyi tamamlamanız gerekiyor <nobr>"<color=#FFF>{0}</color>"</nobr><br><line-height=-20%><br><line-height=100%><size=-3>*Bazı mücadeleler yalnızca özel etkinlikler sırasında kullanılabilir
weeklyCardbackReward=Mücadeleyi tamamlamak size bu kart dekorunu verecektir.
customTrickorTreat=<gl>Tüm düşmanlar bunları kazanır:</gl><br>Tüm hasarlar <bl>+1</bl><br><gl>-Savaş başlangıcı-</gl><br>Her kahraman destesinin en üstüne <crd=trick,1> veya <crd=treat,1> karıştırır.
minDeckCards=Destedeki minimum kart sayısı (Boonlar ve Yaralanmalar hariç): <size=+1><color=#FFFFFF><n></color>
profileMenu=Mevcut profil: <size=+5><color=#B0B0B0>{0}</color></size>
profileCreate=[Profil yarat]
challengeThirdFloorReward=Bu kartın kilidini açmak için mücadelenin üçüncü katına ulaş.
langCommunity=*Topluluk tarafından oluşturulmuştur
itemCorruptionUpgrade=* Bir kahraman aynı eşyayı iki kez kuşandığında, eşya Yükseltilmiş versiyonuna dönüşür.
//////////////////////////////////////////////////////////////////////////////////////////
challengeYlmer=Ormanın Uyanışı
challengeYogger=Tehditkâr Ulumalar 
challengeIgnidoh=Lavdan Zemin
challengeFaeborg=İliklerde Hissedilen Soğukluk
challengeTulah=Yeşil Kan
challengeMinotaur=Vahşi Şampiyonlar
challengeNhir=Zifiri Karanlık

sacredthorns=Kutsal Dikenler
sacredthornsDesc=Dikenler, Delme yerine Kutsal hasar verir.
extremeburning=Ekstrem Yanma
extremeburningDesc=Yanma, hedefin iki veya daha az laneti varsa iki kat hasar verir (Yanma dahil)
frostfire=Buzateş
frostfireDesc=Yanma, Soğuk hasarı verir ayrıca Yanma ve Soğuk direncini yük başına %0,3 azaltır.
intensecold=Şiddetli Soğuk
intensecoldDesc=Soğukluk, Hızı her 5 yük yerine her 4 yük 1 azaltır.
lethalpoison=Ölümcül Zehir
lethalpoisonDesc=Zehir %50 daha fazla hasar verir ancak tur sonunda tüm yüklerini kaybeder.
hemorrhage=Kan Kaybı
hemorrhageDesc=Kanama yükleri +2. Kanama, tur sonunda hasar verir ancak Güçlendirici veya Bağışıklık tarafından engellenemez.
containedfury=Zapt Edilmiş Hiddet
containedfuryDesc=Hiddet, yük başına hasarı %2 artırır ancak artık tur sonunda Kanama uygulamaz.

customChaoticWind=<gl>Tüm düşmanlar bunları kazanır:</gl><br>Hız <bl>+1</bl><br><gl>-Her tur-</gl><br>Rastgele bir karaktere <rd>1<i=fast> 2</rd><i=insane> uygula.
customChaoticWindA=<gl>Tüm düşmanlar bunları kazanır:</gl><br>Hız <bl>+1</bl><br><gl>-Her tur-</gl><br>Rastgele bir karaktere <rd>1<i=fast> 2</rd><i=insane> uygula.
customChaoticWindB=<gl>Tüm düşmanlar bunları kazanır:</gl><br>Hız <bl>+2</bl><br><gl>-Her tur-</gl><br>Rastgele bir karaktere <rd>1<i=fast> 2</rd><i=insane> uygula.
customChaoticWindRare=<gl>Tüm düşmanlar bunları kazanır:</gl><br>Hız <bl>+3</bl><br><gl>-Her tur-</gl><br>Rastgele bir karaktere <rd>1<i=fast> 2</rd><i=insane> uygula.

customLivingForest=<gl>Tüm düşmanlar bunları kazanır:</gl><br>Max HP <bl>+15</bl><br>Tüm hasarlar <bl>+2</bl><br><gl>-Her tur-</gl><br>Rastgele bir düşman <rd>2<i=thorns> 2</rd><i=regeneration> kazanır.
customLivingForestA=<gl>Tüm düşmanlar bunları kazanır:</gl><br>Max HP <bl>+25</bl><br>Tüm hasarlar <bl>+2</bl><br><gl>-Her tur-</gl><br>Rastgele bir düşman <rd>2<i=thorns> 2</rd><i=regeneration> kazanır.
customLivingForestB=<gl>Tüm düşmanlar bunları kazanır:</gl><br>Max HP <bl>+35</bl><br>Tüm hasarlar <bl>+3</bl><br><gl>-Her tur-</gl><br>Rastgele bir düşman <rd>2<i=thorns> 2</rd><i=regeneration> kazanır.
customLivingForestRare=<gl>Tüm düşmanlar bunları kazanır:</gl><br>Max HP <bl>+45</bl><br>Tüm hasarlar <bl>+4</bl><br><gl>-Her tur-</gl><br>Rastgele bir düşman <rd>2<i=thorns> 2</rd><i=regeneration> kazanır.

customStarryNight=<gl>Tüm düşmanlar bunları kazanır:</gl><br>Max HP <bl>+15</bl><br><gl>-Her tur-</gl><br>Rastgele bir kahramana <rd>4<i=kutsal></rd> hasar ver ve <rd>1<i=kutsallaştır> 1</rd><i=yak> uygula.
customStarryNightA=<gl>Tüm düşmanlar bunları kazanır:</gl><br>Max HP <bl>+15</bl><br><gl>-Her tur-</gl><br>Rastgele bir kahramana <rd>4<i=kutsal></rd> hasar ver ve <rd>1<i=kutsallaştır> 1</rd><i=yak> uygula.
customStarryNightB=<gl>Tüm düşmanlar bunları kazanır:</gl><br>Max HP <bl>+15</bl><br><gl>-Her tur-</gl><br>Rastgele bir kahramana <rd>4<i=kutsal></rd> hasar ver ve <rd>1<i=kutsallaştır> 1</rd><i=yak> uygula.
customStarryNightRare=<gl>Tüm düşmanlar bunları kazanır:</gl><br>Max HP <bl>+15</bl><br><gl>-Her tur-</gl><br>Rastgele bir kahramana <rd>4<i=kutsal></rd> hasar ver ve <rd>1<i=kutsallaştır> 1</rd><i=yak> uygula.

customRoseGarden=<gl>Tüm düşmanlar bunları kazanır:</gl><br>Max HP <bl>+15</bl><br><gl>-Savaş başlangıcı-</gl><br>Elde et <bl>5</bl><i=thorns>
customRoseGardenA=<gl>Tüm düşmanlar bunları kazanır:</gl><br>Max HP <bl>+20</bl><br><gl>-Savaş başlangıcı-</gl><br>Elde et <bl>9</bl><i=thorns>
customRoseGardenB=<gl>Tüm düşmanlar bunları kazanır:</gl><br>Max HP <bl>+25</bl><br><gl>-Savaş başlangıcı-</gl><br>Elde et <bl>12</bl><i=thorns>
customRoseGardenRare=<gl>Tüm düşmanlar bunları kazanır:</gl><br>Max HP <bl>+30</bl><br><gl>-Savaş başlangıcı-</gl><br>Elde et <bl>16</bl><i=thorns>

customBombLottery=<gl>Tüm düşmanlar bunları kazanır:</gl><br>Tüm hasarlar <bl>+1</bl><br><gl>-Her tur-</gl><br><crd=bomb,1>'i rastgele bir kahramanın destesine karıştır.
customBombLotteryA=<gl>Tüm düşmanlar bunları kazanır:</gl><br>Tüm hasarlar <bl>+2</bl><br><gl>-Her tur-</gl><br><crd=bomb,1>'i rastgele bir kahramanın destesine karıştır.
customBombLotteryB=<gl>Tüm düşmanlar bunları kazanır:</gl><br>Tüm hasarlar <bl>+1</bl><br><gl>-Her tur-</gl><br><crd=bomb,1>'i rastgele bir kahramanın destesine karıştır.
customBombLotteryRare=<gl>Tüm düşmanlar bunları kazanır:</gl><br>Tüm hasarlar <bl>+3</bl><br><gl>-Her tur-</gl><br><crd=bomb,1>'i rastgele bir kahramanın destesine karıştır.

customAshySky=<gl>Tüm düşmanlar bunları kazanır:</gl><br>Tüm hasarlar <bl>+2</bl><br>Tüm dirençler <bl>+5%</bl><br><gl>-Her tur-</gl><br>Rastgele bir canavara <crd=ashstorm,1> ekle.
customAshySkyA=<gl>Tüm düşmanlar bunları kazanır:</gl><br>Tüm hasarlar <bl>+2</bl><br>Tüm dirençler <bl>+10%</bl><br><gl>-Her tur-</gl><br>Rastgele bir canavara <crd=ashstorm,1> ekle.
customAshySkyB=<gl>Tüm düşmanlar bunları kazanır:</gl><br>Tüm hasarlar <bl>+3</bl><br>Tüm dirençler <bl>+15%</bl><br><gl>-Her tur-</gl><br>Rastgele bir canavara <crd=ashstorm,1> ekle.
customAshySkyRare=<gl>Tüm düşmanlar bunları kazanır:</gl><br>Tüm hasarlar <bl>+4</bl><br>Tüm dirençler <bl>+20%</bl><br><gl>-Her tur-</gl><br>Rastgele bir canavara <crd=ashstorm,1> ekle.

customSnowfall=<gl>Tüm düşmanlar bunları kazanır:</gl><br>Max HP <bl>+15</bl><br><gl>-Savaş başlangıcı-</gl><br>Her kahramanın destesinin en üstüne <crd=coldhands,1> yerleştir ve <rd>5<i=chill> uygula
customSnowfallA=<gl>Tüm düşmanlar bunları kazanır:</gl><br>Max HP <bl>+25</bl><br><gl>-Savaş başlangıcı-</gl><br>Her kahramanın destesinin en üstüne <crd=coldhands,1> yerleştir ve <rd>5<i=chill> uygula
customSnowfallB=<gl>Tüm düşmanlar bunları kazanır:</gl><br>Max HP <bl>+35</bl><br><gl>-Savaş başlangıcı-</gl><br>Her kahramanın destesinin en üstüne <crd=coldhands,1> yerleştir ve <rd>5<i=chill> uygula
customSnowfallRare=<gl>Tüm düşmanlar bunları kazanır:</gl><br>Max HP <bl>+45</bl><br><gl>-Savaş başlangıcı-</gl><br>Her kahramanın destesinin en üstüne <crd=coldhands,1> yerleştir ve <rd>5<i=chill> uygula

customMeatFeast=<gl>Tüm düşmanlar bunları kazanır:</gl><br>Tüm hasarlar <bl>+2</bl><br><gl>-Her tur-</gl><br>Tüm canavarlara <crd=premiummeato,1>, <crd=meato,1> veya <crd=spoiledmeato,1> ekle.

customMeatBag=<act>[İlk tur]</act><br><crd=premiummeat,1>, <crd=meat,1> veya <crd=spoiledmeat,1>'i destene karıştır.
customMeatBagA=Max HP <bl>+3</bl><br><act>[First turn]</act><br><crd=premiummeat,1>, <crd=meat,1> veya <crd=spoiledmeat,1>'i destene karıştır.
customMeatBagB=Max HP <bl>+6</bl><br><act>[First turn]</act><br><crd=premiummeat,1>, <crd=meat,1> veya <crd=spoiledmeat,1>'i destene karıştır.

customForestAllies=<gl>Tüm düşmanlar bunları kazanır:</gl><br>Max HP <bl>+25</bl><br><gl>-Savaş başlangıcı-</gl><br>Tüm canavarlara <crd=forestallya,1>, <crd=forestallyb,1> veya <crd=forestallyc,1> ekle.

customLavaBursts=<gl>Tüm düşmanlar bunları kazanır:</gl><br>Max HP <bl>+25</bl><br><gl>-Every turn-</gl><br>Rastgele bir kahramana <rd>5<i=fire></rd> ve <rd>2<i=burn></rd> uygula.

customColdFront=<gl>Tüm düşmanlar bunları kazanır:</gl><br>Max HP <bl>+25</bl><br><gl>-Every turn-</gl><br>Rastgele bir kahramana <rd>5<i=soğuk></rd> uygula ve <rd>2<i=soğuk></rd> uygula.

customLonelyBlob=<gl>Tüm düşmanlar bunları kazanır:</gl><br>Max HP <bl>+15</bl><br><gl>-Savaş başlangıcı-</gl><br>Rastgele bir düşmana rastgele bir <i=card><color=#5E3016>Blob</color> ekle.
customLonelyBlobA=<gl>Tüm düşmanlar bunları kazanır:</gl><br>Max HP <bl>+25</bl><br><gl>-Savaş başlangıcı-</gl><br>Rastgele bir düşmana rastgele bir <i=card><color=#5E3016>Blob</color> ekle.
customLonelyBlobB=<gl>Tüm düşmanlar bunları kazanır:</gl><br>Max HP <bl>+35</bl><br><gl>-Savaş başlangıcı-</gl><br>Rastgele bir düşmana rastgele bir <i=card><color=#5E3016>Blob</color> ekle.
customLonelyBlobRare=<gl>Tüm düşmanlar bunları kazanır:</gl><br>Max HP <bl>+45</bl><br><gl>-Savaş başlangıcı-</gl><br>Rastgele bir düşmana rastgele bir <i=card><color=#5E3016>Blob</color> ekle.

customColorfulPuddle=<gl>Tüm düşmanlar bunları kazanır:</gl><br>Tüm hasarlar <bl>+1</bl><br>Max HP <bl>+15</bl><br><gl>-Savaş başlangıcı-</gl><br>Tüm düşmanlara rastgele bir <i=card><color=#5E3016>Blob</color> ekle.
customColorfulPuddleA=<gl>Tüm düşmanlar bunları kazanır:</gl><br>Tüm hasarlar <bl>+2</bl><br>Max HP <bl>+25</bl><br><gl>-Savaş başlangıcı-</gl><br>Tüm düşmanlara rastgele bir <i=card><color=#5E3016>Blob</color> ekle.
customColorfulPuddleB=<gl>Tüm düşmanlar bunları kazanır:</gl><br>Tüm hasarlar <bl>+2</bl><br>Max HP <bl>+35</bl><br><gl>-Savaş başlangıcı-</gl><br>Tüm düşmanlara rastgele bir <i=card><color=#5E3016>Blob</color> ekle.
customColorfulPuddleRare=<gl>Tüm düşmanlar bunları kazanır:</gl><br>Tüm hasarlar <bl>+3</bl><br>Max HP <bl>+45</bl><br><gl>-Savaş başlangıcı-</gl><br>Tüm düşmanlara rastgele bir <i=card><color=#5E3016>Blob</color> ekle.

customBloodPuddle=<gl>Tüm düşmanlar bunları kazanır:</gl><br>Tüm hasarlar <bl>+1</bl><br>Max HP <bl>+25</bl><br><gl>-Savaş başlangıcı-</gl><br>Tüm canavarlara <crd=bloodblob,1> ekle.
customChaosPuddle=<gl>Tüm düşmanlar bunları kazanır:</gl><br>Tüm hasarlar <bl>+1</bl><br>Max HP <bl>+25</bl><br><gl>-Savaş başlangıcı-</gl><br>Tüm canavarlara <crd=chaosblob,1> ekle.
customDarkPuddle=<gl>Tüm düşmanlar bunları kazanır:</gl><br>Tüm hasarlar <bl>+1</bl><br>Max HP <bl>+25</bl><br><gl>-Savaş başlangıcı-</gl><br>Tüm canavarlara <crd=darkblob,1> ekle.
customElectricPuddle=<gl>Tüm düşmanlar bunları kazanır:</gl><br>Tüm hasarlar <bl>+1</bl><br>Max HP <bl>+25</bl><br><gl>-Savaş başlangıcı-</gl><br>Tüm canavarlara <crd=electricblob,1> ekle.
customHolyPuddle=<gl>Tüm düşmanlar bunları kazanır:</gl><br>Tüm hasarlar <bl>+1</bl><br>Max HP <bl>+25</bl><br><gl>-Savaş başlangıcı-</gl><br>Tüm canavarlara <crd=holyblob,1> ekle.
customIcyPuddle=<gl>Tüm düşmanlar bunları kazanır:</gl><br>Tüm hasarlar <bl>+1</bl><br>Max HP <bl>+25</bl><br><gl>-Savaş başlangıcı-</gl><br>Tüm canavarlara <crd=icyblob,1> ekle.
customLavaPuddle=<gl>Tüm düşmanlar bunları kazanır:</gl><br>Tüm hasarlar <bl>+1</bl><br>Max HP <bl>+25</bl><br><gl>-Savaş başlangıcı-</gl><br>Tüm canavarlara <crd=lavablob,1> ekle.
customMetalPuddle=<gl>Tüm düşmanlar bunları kazanır:</gl><br>Tüm hasarlar <bl>+1</bl><br>Max HP <bl>+25</bl><br><gl>-Savaş başlangıcı-</gl><br>Tüm canavarlara <crd=metalblob,1> ekle.
customToxicPuddle=<gl>Tüm düşmanlar bunları kazanır:</gl><br>Tüm hasarlar <bl>+1</bl><br>Max HP <bl>+25</bl><br><gl>-Savaş başlangıcı-</gl><br>Tüm canavarlara <crd=toxicblob,1> ekle.
customWaterPuddle=<gl>Tüm düşmanlar bunları kazanır:</gl><br>Tüm hasarlar <bl>+1</bl><br>Max HP <bl>+25</bl><br><gl>-Savaş başlangıcı-</gl><br>Tüm canavarlara <crd=waterblob,1> ekle.

customGainPerHero=Kahraman başına {0} kazan.
customGainPerHeroAnd=Kahraman başına {0} ve {1} kazan.
itemEveryRoundRound=Her tur
menuLog=Combat Log
youMustSelectHero=Şu kahramanı seçmelisiniz:<br><color=#FFC555>{0}</color>
townTutorial=Kasaba eğitimi
townTutorialStep0=Büyülü demirhaneye git ve {1} karşılığında bir "{0}" kartı satın al.
townTutorialStep1=Altara git ve "{0}" kartını {1} karşılığında yükselt.
townTutorialStep2=Cephaneliğe gir ve {1} karşılığında bir "{0}" satın al.
tutorialTownNeedComplete=Kasaba Eğitimini tamamlaman gerekiyor
tutorialTownCraftTitle=Kart üret
tutorialTownCraft=Bir kartı ganimet olarak aldıktan sonra kahramanların için üretebileceksin.<line-height=160%><br></line-height><color=#FFC555>"{0}" kartını {1}</color> ile üret.
tutorialTownCraftDoneTitle=Üret
tutorialTownCraftDone=Maceraların sırasında yeni kartların kilidini açacaksın. Şimdi bir sonraki öğretici adım için Altar'a git.
tutorialTownUpgradeTitle=Kartları dönüştür
tutorialTownUpgrade=Belirli bir miktar kristal ödeyerek kartlarını daha güçlü versiyonlara yükseltebilirsin.<line-height=160%><br></line-height><color=#FFC555>"{0}" kartını {1}'den yükselt</color>.
tutorialTownUpgradeDoneTitle=Dönüştür
tutorialTownUpgradeDone=Bir kartı yükseltmenin maliyetinin kartın nadirliğine bağlı olacağını unutma. Şimdi şehir eğitimini bitirmek için Cephaneliğe git.
tutorialTownLootTitle=Eşya satın al
tutorialTownLoot=Dünyanın dört bir yanına dağılmış kasabalarda ve dükkanlarda, kahramanlarınız için istatistiklerini ve performanslarını artıracak öğeler satın alabilirsin.<line-height=160%><br></line-height><color=#FFC555>"{0}" ile {1}</color> satın al.
tutorialTownLootDoneTitle=Satın al
tutorialTownLootDone=Tebrikler! Kasaba eğitimini bitirdin ve maceraya başlamaya hazırsın!
terrainCondition=Bölge koşulları
terrainConditionDesc=Kahramanların savaşa farklı koşullarla başladığı özel bir bölge türü:
heavyRain=Şiddetli Yağmur
extremeHeat=Aşırı Sıcaklık
freezingCold=Dondurucu Soğuk
holyGround=Kutsal Toprak
graveyard=Mezarlık
poisonousAir=Zehirli Hava
frozenSewers=Donmuş Kanalizasyonlar
blackForge=Kara Demirhane
wolfWars=Kurt Savaşları
wolfWarsIntro=Senenthia Kralı ile evlendikten birkaç yıl sonra Kraliçe Amelia, bağları güçlendirmek ve krallığın tüm farklı ırklarını tek bir bayrak altında toplamak için bir seferberlik başlattı.<br><br>Kurtadamlar tarafından her zaman rahatsız edilen ve avlanan ırkların çoğu bu teklifi umutla kabul etti. Ancak Kabile Reisi Gorio, ormanın kuzeydoğu kısmını yönetmeye devam etmek istedi ve kurtadamları için özgürce avlanma hakkı talep etti.<br><br>Kraliçe Amelia ve Kabile Reisi Gorio arasında aylar süren görüşmelerin ardından, kabile reisi görüşmeleri kesti. Gorio, kurtadamlarının evcilleştirilmeyeceğini ve ormana giren herkesin onun avı olacağını ilan etti.<br><br>Krallıktaki tüm ırkların yakarışlarından etkilenen ve onları korumayı amaçlayan Kraliçe Amelia, Gorio'yu devirmek için bir saldırı başlatmaya karar verdi.
bandit=Haydut
food=Yemek
roadmapHomeText=<tit>Welcome, everyone!</tit>We have just released version 1.1 of the game, with a lot of free content such as two new sub-zones, new items, and new features like the combat log.<br><br>Also, we have released our first story DLC, The Wolf Wars, which includes a new hero, skins, etc. We hope you like it!<br><br><tit>What's next?</tit>We'll work on the heropedia with a little twist. And we will focus on the first big DLC, a big zone for acts 2 and 3 full of new enemies, items, events, and new heroes!
requiredEvent="{0}" etkinliğini tamamlaman gerekiyor.

challengeHydra=Tehlikeli Sular
icydeluge=Buzlu Tufan
icydelugeDesc=Islaklık yükü +1. Islaklık ayrıca alınan Soğuk hasarını yük başına 1 artırır.

cardbackDangerousWaters=rptd_challengeHydra
cardbackFloorIsLava=rptd_challengeIgnidoh
cardbackForestAwakens=rptd_challengeYlmer
cardbackFrozenToTheBone=rptd_challengeFaeborg
cardbackGreenBlood=rptd_challengeTulah
cardbackPitchBlack=rptd_challengeNhir
cardbackThreateningHowls=rptd_challengeYogger
cardbackWildChampions=rptd_challengeMinotaur

////////////////////////// new no enviado /////
dlcAcronymForCharSelection=DLC

cardbackTitle0=Karakter
cardbackTitle1=Genel
cardbackTitle2=Diğer

itemRecoverLowestHPHero=en düşük HP kahraman {0} sağlık iyileşir

customButchersTable=Maksimum Sağlık <bl>+10</bl><br><gl>[Her tur]</gl><br>Eline <crd=premiummeat,1>, <crd=meat,1> veya <crd=spoiledmeat,1> koy.
customButchersTableRare=Maksimum Sağlık <bl>+20</bl><br><gl>[Her tur]</gl><br>Eline <crd=premiummeat,1>, <crd=meat,1> veya <crd=bloodsausage,1> koy.

customMainperkFortify1c=Kahramanlardaki Takviye, turun sonunda tüm yükleri kaybeder ve ayrıca kaldırılan yük başına 10 Blok verir.
requiredDLCandQuest=<nobr>"<color=#FFF>{0}</color>"</nobr> DLC'sine sahip olmanız ve bir etkinliği tamamlamanız gerekiyor
characterSkin=Karakter Kostümü
playerDontHaveDLC=Bu oyuncu DLC'ye sahip değil <nobr>"<color=#FFF>{0}</color>"</nobr>
enableKeysOption=Klavye kısayollarını etkinleştirme
enableKeysOptionDes=Kısayol numaraları savaş sırasında da gösterilecektir//This option will also be activated if you use any shortcut key during combat.

consoleDraw=<color=#AAA>({0}) Kart çek</color> {1} // 0 is the number of cards and 1 is a list of auras
consoleCardToHand={0} <color=#AAA>eline koyar</color> // {0} is character name
consoleCardToTopDeck={0} <color=#AAA>destenin tepesine koyar</color> // {0} is character name
consoleCardToBottomDeck={0} <color=#AAA>destenin en altına koyar</color> // {0} is character name
consoleCardToRandomDeck={0} <color=#AAA>destenin içine karıştırır</color> // {0} is character name
consoleCardToDiscard={0} <color=#AAA>ıskartalar</color>
consoleCardToVanish={0} <color=#AAA>yok eder</color> // {0} is character name
consoleCardModification={0} <color=#AAA>kartı değiştirir</color> // {0} is character name
consoleCorruptionActivated=Corruption activated
consoleItemActivated=Eşya etkinleştirildi
consoleTraitActivated=Özellik etkinleştirildi
consoleCharacterCasted={0} <color=#AAA>kullandı</color> *** // {0} is character name
consoleBeginTurn=<b>{0}</b> <link={1}><color=#B7789E><u>Turu başladı</u></color></link> // {0} is character name
consoleEndTurn=<b>{0}</b> <link={1}><color=#B7789E><u>Turu bitti</u></color></link> // {0} is character name
consoleCombatStatus=Savaş İstatistikleri

/////////////////  Ulminin translation ///////////////////////////////////

yoggerPet1=Ben Magnus'a benzemem!
yoggerPet2=Bu ne cüret! Seni kıymaya çevireceğim!

fallen=Fallen
zealot=Zealot
vanguard=Vanguard
wraith=Wraith
revenant=Revenant
zeal=Zeal
scourge=Scourge
dualClassReward=* Çift sınıflı karakterler her zaman 4 kart ödülü alır (her karakter sınıfı için 2).

cardsXEqualsYourSpeed=(X hızına eşittir {0})
cardsXEqualsTargetSpeed=(X hedef hızına eşittir {0})
cardsXEqualsDifferenceSpeed=(X seninle hedef arasındaki hız farkına eşittir {0})

customBookoftheDead=Tüm Hasarlar <bl>+4</bl><br><color=#4D4D4D>[Karakter ölür]</color><br>Cast <crd=raisemage,1>, <crd=raisepriest,1> or <crd=raisewarlock,1><br><color=#4D4D4D>[1 time / combat]
customBookoftheDeadrare=Tüm hasarlar <bl>+6</bl><br><color=#4D4D4D>[Karakter ölür]</color><br>Cast <crd=raisemagerare,1>, <crd=raisepriestrare,1> or <crd=raisewarlockrare,1><br><color=#4D4D4D>[1 time / combat]

customMixedSalad=Maks Sağlık <bl>+5</bl><br><gl>[Her tur]</gl><br>Eline <crd=tomato,1>, <crd=carrot,1> veya <crd=broccoli,1> koy.
customMixedSaladrare=Maks Sağlık <bl>+15</bl><br><gl>[Her tur]</gl><br>Eline <crd=tomato,1>, <crd=carrot,1> veya <crd=broccoli,1> koy.

customBurningBlood=Dönüştür<i=bleed> -> <i=burn>x0.3<br>Elde et<bl>X</bl><i=fury><br><size=-.15><gl>(X eşittir senin<i=bleed>x0.3)</gl></size>
customBurningBloodA=Dönüştür<i=bleed> -> <i=burn>x0.3<br>Bahşet<bl>X</bl><i=fury><br><size=-.15><gl>(X eşittir senin<i=bleed>x0.3)</gl></size>
customBurningBloodRare=Dönüştür<i=bleed> -> <i=burn>x0.5<br>Bahşet<bl>X</bl><i=fury><br><size=-.15><gl>(X eşittir senin<i=bleed>x0.3)</gl></size>

pickRandomHero=Rastgele bir kahraman seç
cardsXEqualsYourDiscardedCards=(X eşittir ıskarta <space=.1><sprite name=card>{0})
cardsXEqualsYourVanishedCards=(X eşittir yok olmuş <space=.1><sprite name=card>{0})
cardsXEqualsTargetMissingHealth=(X hedefin eksik sağlığına eşittir {0})
cardsXEqualsYourMissingHealth=(X senin eksik sağlığına eşittir {0})
itemEveryRoundRoundN=Her {0} turda
itemReduceCost=(maliyet >= {0} ile)
scarabBonus=Bokböceği bonusu: {0} / kahraman başına
itemTwicePerCombat=Savaş başına iki kez
itemThricePerCombat=Savaş başına üç kez
customCrystallize=Kahraman başına 150<i=dust> ek ödül oluşturur.
escapes=Kaçış
luckyscarab=Şanslı Bokböceği
useSupplies=Bu karakterin rütbesini artırmak için erzakları kullan.
useSuppliesAvailable=[ {0}  <sprite name=supply> mevcut ]  /// 10 <supplies> available
useSuppliesRequirement=*Karakter rütbesinin 10 olmasını ve Kasaba yükseltmelerinin tamamen açılmasını gerektirir.

customMeatBagA=<i=slashing>dirençli <bl>+3%</bl><br><act>[İlk tur]</act><br><crd=premiummeat,1>, <crd=meat,1> veya <crd=spoiledmeat,1>'i destene karıştır.
customMeatBagB=<i=slashing> dirençli <bl>+5</bl><br><act>[İlk tur]</act><br><crd=premiummeat,1>, <crd=meat,1> veya <crd=spoiledmeat,1>'i destene karıştır.
cardsVanish={0} Yok et

itemSixPerTurn=tur başına 6 kez
itemSevenPerTurn=tur başına 7 kez
itemEightPerTurn=tur başına 8 kez
cardsIDPlaceDiscard=Iskarta destene {0} yerleştir// 0 => cardname
ulminin=Ulminin Çölü
impedingDoomDesc=Performans "Etkileyici değil" seviyesine ulaştığında tüm kahramanlar 3 "Doom"a maruz kalır.
resistantMonstersDesc=Tüm canavarlar tüm dirençlerine ek +%10 kazanır.
decadenceDesc=Tüm kahramanlar <nobr>-%20</nobr> iyileştirme alır ve Zindelik kazanılan maksimum sağlığın yalnızca %50'sini iyileştirir.

customMainperkPowerful1c=Bu kahraman üzerindeki Kuvvetli efekti, verilen hasarı ve iyileştirmeyi yük başına %10 artırır. Maksimum yük 3 azaltılır ve tur sonunda tüm yükler kaybedilir.
customMainperkInspire0a=Bu kahraman ilk turunda 1 İlham kazanır.
customMainperkSharp1d=Bu kahraman üzerindeki Keskinlik ayrıca Gölge hasarını yük başına 1 artırır. 

pyramid=Antik Piramit
cardPlayerPairsDescription=Bu kartlar karıştırıldıktan sonra, karakterler sırayla her seferinde bir kart seçecektir. Eğer bir ikili yaparsanız, <color=#C59559>her iki karakter de ödülü kazanır</color>, aksi takdirde kartlar tekrar gizlenir.<br><br>Kart seçim sırası rastgeledir ve her 2 turda bir karıştırılacaktır. Oyunun kurucusu her turun sonunda oyunu bitirebilir.
finishGame=Oyunu bitir
cardPlayerPairsRound=<color=#FFF>Round [{0}/{1}]</color><br><color={2}>{3}'ün sırası</color>

customArmagedon=<gl>Tüm düşmanlar bunları kazanır:</gl><br>Tüm hasarlar <bl>+2</bl><br><i=fire><i=darbe> dirençli <bl>+30%</bl><br><gl>-Her tur-</gl><br>Tüm canavarlara <crd=meteorite,1> ekle.
customArmagedonA=<gl>Tüm düşmanlar bunları kazanır:</gl><br>Tüm hasarlar <bl>+2</bl><br><i=fire><i=darbe> dirençli <bl>+40%</bl><br><gl>-Her tur-</gl><br>Tüm canavarlara <crd=meteorite,1> ekle.
customArmagedonB=<gl>Tüm düşmanlar bunları kazanır:</gl><br>Tüm hasarlar <bl>+3</bl><br><i=fire><i=darbe> dirençli <bl>+45%</bl><br><gl>-Her tur-</gl><br>Tüm canavarlara <crd=meteorite,1> ekle.
customArmagedonRare=<gl>Tüm düşmanlar bunları kazanır:</gl><br>Tüm hasarlar <bl>+4</bl><br><i=fire><i=darbe> dirençli <bl>+45%</bl><br><gl>-Her tur-</gl><br>Tüm canavarlara <crd=meteorite,1> ekle.

customHeavenlyArmaments=<gl>Tüm düşmanlar bunları kazanır:</gl><br>Maks Sağlık <bl>+15</bl><br><gl>-Her tur-</gl><br>Kazan <bl>2</bl><i=bless><bl>2</bl><i=regeneration><bl>2</bl><i=vitality><bl>1</bl><i=zeal><bl>1</bl><i=fast>
customHeavenlyArmamentsA=<gl>Tüm düşmanlar bunları kazanır:</gl><br>Maks Sağlık <bl>+30</bl><br><gl>-Her tur-</gl><br>Kazan <bl>3</bl><i=bless><bl>3</bl><i=regeneration><bl>2</bl><i=vitality><bl>2</bl><i=zeal><bl>1</bl><i=fast>
customHeavenlyArmamentsB=<gl>Tüm düşmanlar bunları kazanır:</gl><br>Maks Sağlık <bl>+45</bl><br><gl>-Her tur-</gl><br>Kazan <bl>3</bl><i=bless><bl>3</bl><i=regeneration><bl>3</bl><i=vitality><bl>2</bl><i=zeal><bl>2</bl><i=fast>
customHeavenlyArmamentsRare=<gl>Tüm düşmanlar bunları kazanır:</gl><br>Maks Sağlık <bl>+60</bl><br><gl>-Her tur-</gl><br>Kazan <bl>3</bl><i=bless><bl>3</bl><i=regeneration><bl>3</bl><i=vitality><bl>3</bl><i=zeal><bl>2</bl><i=fast>

customPutrefaction=<gl>Tüm düşmanlar bunları kazanır:</gl><br>Tüm hasarlar <bl>+2</bl><br>bağışıklık <i=scourge><i=decay><br><gl>Bir düşman hasar verdiğinde,</gl> bu efekti uygular: <rd>2</rd><i=dark><rd>1</rd><i=decay>
customPutrefactionA=<gl>Tüm düşmanlar bunları kazanır:</gl><br>Tüm hasarlar <bl>+2</bl><br>bağışıklık <i=scourge><i=decay><br><gl>Bir düşman hasar verdiğinde,</gl> bu efekti uygular: <rd>3</rd><i=dark><rd>1</rd><i=decay>
customPutrefactionB=<gl>Tüm düşmanlar bunları kazanır:</gl><br>Tüm hasarlar <bl>+3</bl><br>bağışıklık <i=scourge><i=decay><br><gl>Bir düşman hasar verdiğinde,</gl> bu efekti uygular: <rd>3</rd><i=dark><rd>2</rd><i=decay>
customPutrefactionRare=<gl>Tüm düşmanlar bunları kazanır:</gl><br>Tüm hasarlar <bl>+4</bl><br>bağışıklık <i=scourge><i=decay><br><gl>Bir düşman hasar verdiğinde,</gl> bu efekti uygular: <rd>4</rd><i=dark><rd>2</rd><i=decay>

customMelancholy=<gl>Tüm düşmanlar bunları kazanır:</gl><br>Max HP <bl>+15</bl><br>Tüm dirençler <bl>+10%</bl><br><i=mind> dirençli <bl>+20%</bl><br><gl>-Her tur-</gl><br>Her bir kahraman destesine <crd=sad,2> karıştır.</color>
customMelancholyA=<gl>Tüm düşmanlar bunları kazanır:</gl><br>Max HP <bl>+25</bl><br>Tüm dirençler <bl>+15%</bl><br><i=mind> dirençli <bl>+20%</bl><br><gl>-Her tur-</gl><br>Her bir kahraman destesine <crd=sad,2> karıştır.</color>
customMelancholyB=<gl>Tüm düşmanlar bunları kazanır:</gl><br>Max HP <bl>+35</bl><br>Tüm dirençler <bl>+20%</bl><br><i=mind> dirençli <bl>+25%</bl><br><gl>-Her tur-</gl><br>Her bir kahraman destesine <crd=sad,2> karıştır.</color>
customMelancholyRare=<gl>Tüm düşmanlar bunları kazanır:</gl><br>Max HP <bl>+45</bl><br>Tüm dirençler <bl>+25%</bl><br><i=mind> dirençli <bl>+25%</bl><br><gl>-Her tur-</gl><br>Her bir kahraman destesine <crd=sad,2> karıştır.</color>

customNoxiousParasites=<gl>Tüm düşmanlar bunları kazanır:</gl><br>Tüm hasarlar <bl>+2</bl><br><i=slashing><i=piercing><i=shadow> dirençli <bl>+30%</bl><br><gl>-Her tur-</gl><br>Her kahraman destesine <crd=hatchcorrupt,1> karıştır.
customNoxiousParasitesA=<gl>Tüm düşmanlar bunları kazanır:</gl><br>Tüm hasarlar <bl>+2</bl><br><i=slashing><i=piercing><i=shadow> dirençli <bl>+40%</bl><br><gl>-Her tur-</gl><br>Her kahraman destesine <crd=hatchcorrupt,1> karıştır.
customNoxiousParasitesB=<gl>Tüm düşmanlar bunları kazanır:</gl><br>Tüm hasarlar <bl>+3</bl><br><i=slashing><i=piercing><i=shadow> dirençli <bl>+45%</bl><br><gl>-Her tur-</gl><br>Her kahraman destesine <crd=hatchcorrupt,1> karıştır.
customNoxiousParasitesRare=<gl>Tüm düşmanlar bunları kazanır:</gl><br>Tüm hasarlar <bl>+4</bl><br><i=slashing><i=piercing><i=shadow> dirençli <bl>+45%</bl><br><gl>-Her tur-</gl><br>Her kahraman destesine <crd=hatchcorrupt,1> karıştır.

customPoisonFields=<gl>Tüm düşmanlar bunları kazanır:</gl><br>Tüm hasarlar <bl>+2</bl><br>Tüm dirençler <bl>+5%</bl><br><gl>-Her tur-</gl><br>Tüm kahramanlara <rd>3<rd><i=zehir> uygulanır
customPoisonFieldsA=<gl>Tüm düşmanlar bunları kazanır:</gl><br>Tüm hasarlar <bl>+2</bl><br>Tüm dirençler <bl>+10%</bl><br><gl>-Her tur-</gl><br>Tüm kahramanlara <rd>3<rd><i=zehir> uygulanır
customPoisonFieldsB=<gl>Tüm düşmanlar bunları kazanır:</gl><br>Tüm hasarlar <bl>+3</bl><br>Tüm dirençler <bl>+15%</bl><br><gl>-Her tur-</gl><br>Tüm kahramanlara <rd>3<rd><i=zehir> uygulanır
customPoisonFieldsRare=<gl>Tüm düşmanlar bunları kazanır:</gl><br>Tüm hasarlar <bl>+4</bl><br>Tüm dirençler <bl>+20%</bl><br><gl>-Her tur-</gl><br>Tüm kahramanlara <rd>3<rd><i=zehir> uygulanır

customRevenge=<gl>Tüm düşmanlar bunları kazanır:</gl><br>Tüm hasarlar <bl>+2</bl><br><i=slashing><i=darbe><i=piercing> dirençli <bl>+20%</bl><br><gl>Bir kahraman bir "Saldırı" oynadığında,</gl> tüm canavarlar <bl>3</bl><i=öfke> kazanır.
customRevengeA=<gl>Tüm düşmanlar bunları kazanır:</gl><br>Tüm hasarlar <bl>+2</bl><br><i=slashing><i=darbe><i=piercing> dirençli <bl>+25%</bl><br>><gl>Bir kahraman bir "Saldırı" oynadığında,</gl> tüm canavarlar <bl>4</bl><i=öfke> kazanır.
customRevengeB=<gl>Tüm düşmanlar bunları kazanır:</gl><br>Tüm hasarlar <bl>+3</bl><br><i=slashing><i=darbe><i=piercing> dirençli <bl>+30%</bl><br><gl>Bir kahraman bir "Saldırı" oynadığında,</gl> tüm canavarlar <bl>5</bl><i=öfke> kazanır.
customRevengeRare=<gl>Tüm düşmanlar bunları kazanır:</gl><br>Tüm hasarlar <bl>+4</bl><br><i=slashing><i=darbe><i=piercing> dirençli <bl>+35%</bl><br><gl>Bir kahraman bir "Saldırı" oynadığında,</gl> tüm canavarlar <bl>6</bl><i=öfke> kazanır.

customSubZero=<gl>Tüm düşmanlar bunları kazanır:</gl><br>Tüm hasarlar <bl>+2</bl><br><i=cold> dirençli <bl>+30%</bl><br>bağışıklık <i=slow><br><gl>-Her iki turda bir-</gl><br>Tüm canavarlara <crd=freezecorruption,1> ekler.
customSubZeroA=<gl>Tüm düşmanlar bunları kazanır:</gl><br>Tüm hasarlar <bl>+2</bl><br><i=cold> dirençli <bl>+40%</bl><br>bağışıklık <i=slow><br><gl>-Her iki turda bir-</gl><br>Tüm canavarlara <crd=freezecorruption,1> ekler.
customSubZeroB=<gl>Tüm düşmanlar bunları kazanır:</gl><br>Tüm hasarlar <bl>+3</bl><br><i=cold> dirençli <bl>+45%</bl><br>bağışıklık <i=slow><br><gl>-Her iki turda bir-</gl><br>Tüm canavarlara <crd=freezecorruption,1> ekler.
customSubZeroRare=<gl>Tüm düşmanlar bunları kazanır:</gl><br>Tüm hasarlar <bl>+4</bl><br><i=cold> dirençli <bl>+45%</bl><br>bağışıklık <i=slow><br><gl>-Her iki turda bir-</gl><br>Tüm canavarlara <crd=freezecorruption,1> ekler.

sandbox=Sandbox
sandboxMode=Sandbox mode
sandboxModeTitle=Sandbox mode <size=-2><color=#888>(Only available after you've completed the adventure)
sandboxEnable=Enable Sandbox
sandboxDisable=Disable Sandbox
sandboxMideDescription=In this mode, your score will not be saved and you will not unlock any madness level.
sandboxStartingOptions=Starting options
sandboxCombatOptions=Combat options
sandboxStartingEnergy=<sprite name=energy>Starting energy
sandboxSpeed=<sprite name=speedMini>Hero speed
sandboxGold=<sprite name=gold>Starting gold
sandboxShards=<sprite name=dust>Starting shards
sandboxAdventureOptions=Adventure options
sandboxCraft=<sprite name=cards>Card craft cost
sandboxRemove=<sprite name=cards>Card remove cost
sandboxTransform=<sprite name=cards>Card transform cost
sandboxUpgrade=<sprite name=cards>Card upgrade cost
sandboxEquipment=<sprite name=armor>Equipment cost
sandboxPets=<sprite name=pet>Pets cost
sandboxAllCards=<sprite name=cards>All cards unlocked
sandboxRarity=<sprite name=cards>Card craft rarity
sandboxCraftAvailable=<sprite name=cards>Available card limit
sandboxDeckSize=<sprite name=cards>Minimum deck size
sandboxRerolls=<sprite name=nodeShop>Armory rerolls
sandboxRerollsTimes=<sprite name=nodeShop>Maximum rerolls
sandboxDivination=<sprite name=cardrandom>Divination cost
sandboxEvents=<sprite name=dice>Event rolls succeed
sandboxHeroes=<sprite name=experience>Total heroes
sandboxMonstersHP=<sprite name=heart>Monster HP
sandboxMonstersDamage=<sprite name=damage>Monster Damage
sandboxRemoveMonsters=<sprite name=doom>Remove monsters
sandboxDoubleChampions=<sprite name=boss>Double champions
yesRandomCombats=Yes <color=#888><size=-.5>(random combats must be enabled)
yes=Yes
unlimited=Unlimited
always=Always
all=All
disabled=Disabled

card=Card
////////////// Christmas DLC
keyQ=Q
keyW=W
keyE=E
keyR=R
keyT=T
keyY=Y
keyU=U
keyI=I
keyO=O
keyP=P
keyA=A
keyS=S
keyD=D
keyF=F
keyG=G
keyH=H
keyJ=J
keyK=K
keyL=L
keyZ=Z
keyX=X
keyC=C
keyV=V
keyB=B
keyN=N
keyM=M
keyShift=Shift
keyReturn=Accept
keyDelete=Delete

customScaraby=All resistances <bl>+5%</bl><br>Increases the chance of a scarab spawning in Acts 2 and 3 by up to <bl>40%</bl>.
customScarabyrare=All resistances <bl>+8%</bl><br>Increases the chance of a scarab spawning in Acts 2 and 3 by up to <bl>50%</bl>.<br>Scourge scarabs do not spawn.

queen=Queen
princess=Princess
empress=Empress
engineer=Engineer
mechanic=Mechanic
artificer=Artificer
chatWelcome=<u>{0}</u> oyununa hoş geldiniz. Bu sohbet penceresi aracılığıyla diğer oyuncularla iletişim kurabileceksiniz. Ayrıca, oyunun geri kalanında her birinin aynı renkle anılacağını unutmayın. İyi eğlenceler!
maximumEnchantments=Bir karakter en fazla üç aktif efsuna sahip olabilir. Yeni bir tane uygulandığında, en eskisi kaldırılacaktır.